Title,City,District,Building_Area,Land_Area,Price,Area_Total,Category
"Townhouse 2 lntai.,",Jakarta,Lubang Buaya,80,72,850000000,152,Small
"Siap Huni,Lokasi dekat Tol Brigif Jagakarsa...",Jakarta,Jagakarsa,130,88,1750000000,218,Medium
Rumah Minimalis 2 Lantai Siap Huni Dekat Cilandak Harga Nego Bisa KPR,Jakarta,Cilandak,120,78,1500000000,198,Medium
Siap Indent di Lokasi Premium Jagakarsa/ THE COACH HOUSE,Jakarta,Tanjung Barat,130,63,1960000000,193,Medium
rumah Classic 3 lantai mewah murah,Jakarta,Jagakarsa,230,80,2600000000,310,Large
DIJUAL 2 UNIT RUMAH BARU SIAP HUNI DURI MAS,Jakarta,Duri Kepa,125,58,1950000000,183,Medium
rumah Classic modern termurah jagakarsa,Jakarta,Jagakarsa,130,95,1700000000,225,Medium
Runah Murah minimalis dan Cantik dengan Harga terjangkau di Jakarta Pu,Jakarta,Johar Baru,30,16,370000000,46,Small
rumah sia huni 3 lantai kebagusan,Jakarta,Kebagusan,250,108,3600000000,358,Large
Rumah Menteng 2 lantai,Jakarta,Menteng Dalam,609,830,78000000000,1439,Large
Jual Cepat Rumah siap huni,Jakarta,Duren Sawit,350,250,4900000000,600,Large
RUMAH MURAH INDENT DI JAKARTA PUSAT,Jakarta,Cempaka Putih,37,20,460000000,57,Small
Rumah 3 Lantai Di Cempaka Putih Tengah Dgn Konsep Smart Home Jak Pus,Jakarta,Cempaka Putih,85,30,1240000000,115,Small
"Jual Rumah Jakarta - Rumah Lokasi PEGANGSAAN, MENTENG, JAKARTA PUSAT - NEGO !!",Jakarta,Pegangsaan,145,95,5200000000,240,Medium
Dijual Rumah Baru Pondok Indah,Jakarta,,462,269,15000000000,731,Large
"Rumah Baru Siap Huni Pesangrahan Jaksel, NEGO SAJA",Jakarta,Pesanggrahan,180,141,2500000000,321,Large
Dijual Cepat Rumah Kelapa Gading Kelapa Cengkir Timur,Jakarta,Kelapa Gading,162,162,3650000000,324,Large
Rumah Dengan Promo Harvest City Cibubur,Jakarta,Cibubur,37,72,500000000,109,Small
"Rumah Dijual Baru Desain Minimalis, KPR DP 0% Dekat Tol Cibubur",Jakarta,Cibubur,88,70,1382000000,158,Small
"Rumah Kelapa Gading BCS 6x14m 2,5 lantai, minimalis bagus, jalan 2 mobil",Jakarta,Kelapa Gading,150,84,1650000000,234,Medium
Dijual Cepat Rumah Cantik Mewah Di City Resort Hawaii Jalan Boulevard,Jakarta,Cengkareng,504,144,4400000000,648,Large
"Rumah Asri kebayoran lama, Jakarta Selatan",Jakarta,Kebayoran Lama,340,540,8800000000,880,Large
DIJUAL RUMAH DUREN SAWIT,Jakarta,Duren Sawit,600,807,17000000000,1407,Large
RUMAH SIAP BANGUN DI JAKARTA TIMUR DENGAN LINGKUNGAN ASRI DAN NYAMAN,Jakarta,Lubang Buaya,60,92,1150000000,152,Small
Mudah Punya Rumah Hanya Harvest City Cibubur,Jakarta,Cibubur,30,60,500000000,90,Small
DIJUAL RUMAH CANTIK TERAWAT 2 LANTAI POSISI HOOK SIAP HUNI DEKAT MRT,Jakarta,Lebak Bulus,400,241,5000000000,641,Large
The Ridge Crystal Ada Club House Perumahan Harvest City,Jakarta,Cibubur,42,72,700000000,114,Small
"Pondok indah,Metro Alam,Bulevard,udara Sejuk 300m dr Lap Golf, PI Mall",Jakarta,Pondok Indah,640,940,38500000000,1580,Large
Rumah MEWAH Pinggir Jalan Dekat Exit Tol JORR 2 Ciledug - Kebayoran Lama,Jakarta,Pesanggrahan,450,435,7200000000,885,Large
"Rumah Sunter Agung Barat 9x11m 2,5 lantai rapi, tinggal masuk, murah",Jakarta,Sunter Agung,148,99,2400000000,247,Medium
Dijual Rumah Mewah 3 Lantai dan Siap Huni Perumahan Pondok Bambu,Jakarta,Pondok Bambu,550,260,4500000000,810,Large
Rumah di Jual Komplek Large Dekat Tol Bambu Apus Cipayung Jakarta Timur,Jakarta,Cipayung,140,78,1495000000,218,Medium
RUMAH SIAP HUNI DEKAT PIZZA HUT KEMANG,Jakarta,Kemang,610,539,10870000000,1149,Large
DiJual Rumah Siap Huni,Jakarta,Jatinegara,75,105,1300000000,180,Small
"Rumah Mewah bebas banjir di Cipayung, Jaktim",Jakarta,,80,73,1002540000,153,Small
RUMAH MURAH 2LANTAI GN SINDUR (PROMO 3JUTA 5TAHUN),Jakarta,Cilandak,45,80,314000000,125,Small
Dijual rumah Mewah lokasi Nyaman dan Asri Kawasan elit pondok indah,Jakarta,Pondok Indah,1200,890,47000000000,2090,Large
rumah minimalis Pulomas dataran tinggi bebas banjir,Jakarta,Pulo Gadung,180,90,3100000000,270,Large
HOT PRODUCT Rumah Mewah Pondok Cibubur Nyaman Banget CASH & KPR,Jakarta,Cilangkap,70,61,790000000,131,Small
Hunian Murah Jambu Hills Jagakarsa Ciganjur Ragunan - TRANSMART Cilandak,Jakarta,Jagakarsa,135,76,1300000000,211,Medium
RUMAH SIAP HUNI DENAGN HALAMAN LUAS DEKAT PLATARAN,Jakarta,Jagakarsa,100,1016,10160000000,1116,Medium
Hunian 2 Lantai Cluster Nyaman Strategis Cimanggis Depok SHM GRATIS BIAYA2,Jakarta,Pasar Rebo,65,60,770000000,125,Small
Jual Rumah murah Modern 2 Lantai di Pisangan Baru Jakarta Timur,Jakarta,Pisangan Baru,63,32,700000000,95,Small
"Rumah rawamangun tenang, nyaman, aman, dan bebas banjir",Jakarta,Rawamangun,155,140,3000000000,295,Large
MILIKI RUMAH 3 LANTAI DI BAWAH 1 M DI KAWASAN MENTENG,Jakarta,Kwitang,153,53,750000000,206,Large
DiJual Rumah Siap Huni,Jakarta,Jatinegara,100,90,1650000000,190,Medium
"Rumah Cluster Proyek ke,6 Dekat TOL & KRL Cibubur Termurah 700jutaan",Jakarta,Cipayung,68,63,799000000,131,Small
"jual rumah di rawamangun jakarta timur 2 dan 3 lantai harga 1,2M",Jakarta,Rawamangun,78,42,1350000000,120,Small
Rumah siap huni dengan luas 10x22 220m2 type 4KT Tanjung Priok Jakarta Utara,Jakarta,Tanjung Priok,200,220,1500000000,420,Large
"Jual rumah nyaman, aman dan strategis",Jakarta,Slipi,200,105,2100000000,305,Large
DiJual Rumah Siap Huni,Jakarta,Jatinegara,100,90,1650000000,190,Medium
DiJual Rumah Sudah Siap Huni,Jakarta,Jatinegara,120,120,1900000000,240,Medium
jual cluster minimalis kredit developer dijakarta timur,Jakarta,Lubang Buaya,40,40,399000000,80,Small
Rumah 2 lantai dekat mrt lebak bulus dan busway,Jakarta,Lebak Bulus,90,105,994000000,195,Small
Dijual Rumah with rooftop Akses Pinggir jalan 2 mobil dkt cilandak dijagakarsa,Jakarta,Jagakarsa,150,87,1875000000,237,Medium
Dijual Rumah Cantik di Jakarta Selatan Cilandak,Jakarta,Cilandak,150,101,4350000000,251,Medium
Dijual Rumah 3 Lantai di Janur Hijau Lokasi Strategis Dekat Mall dan Perkantoran,Jakarta,Kelapa Gading,150,150,4850000000,300,Medium
Hunian tipe cluster di Paseban timur Jakarta pusat,Jakarta,,45,22,350000000,67,Small
DIJUAL CEPAT RUMAH 5 KAMAR TIDUR TANJUNG DUREN LOKASI STRATEGIS,Jakarta,Tanjung Duren,150,157,2700000000,307,Medium
"Precium Simatupang , townhouse terbaru di ampera kemang",Jakarta,TB Simatupang,200,130,7000000000,330,Large
Turun Harga Rumah Kost Senen Murah Strategis Full Anti Pandemi,Jakarta,Senen,1553,774,19000000000,2327,Large
Tanah dan 4 bangunan diatasnya,Jakarta,Petukangan Utara,500,710,15000000000,1210,Large
Rumah Minimalis 2 lantai lokasi dekat suntermall dan stadion jis,Jakarta,Tanjung Priok,33,21,450000000,54,Small
Rumah Minimalis dengan harga murah di Utan Kayu Jl Sirsak Jaktim,Jakarta,Utan Kayu,42,21,410000000,63,Small
Rumah baru 2 tingkat murah bebas banjir GRAND KARTIKA Cibubur,Jakarta,Cibubur,98,98,1800000000,196,Medium
Rumah luas dan Bagus di Lebak Bulus,Jakarta,Lebak Bulus,1800,1025,22000000000,2825,Large
RUMAH DIJUAL DI OTISTA (NEGO SAMPAI JADI) !!!,Jakarta,,600,400,9000000000,1000,Large
Dijual Rumah Daerah Manggarai Strategis Ditengah Kota Jakarta,Jakarta,,200,199,2800000000,399,Large
Rumah Bagus Siap Huni Dijual di Johar Baru,Jakarta,Johar Baru,186,252,7000000000,438,Large
Dijual rumah homey di billy moon pondok kelapa.,Jakarta,Duren Sawit,118,116,1750000000,234,Medium
Rumah Mewah Jalan Benda Jagakarsa Dkt Ragunan Kebagusan Cilandak,Jakarta,Jagakarsa,150,98,1750000000,248,Medium
rumah cluster nyaman asri shm dekat tol Cibubur,Jakarta,Pasar Rebo,68,60,790000000,128,Small
Asya Cluster Kelimutu,Jakarta,Cakung,105,105,4000000000,210,Medium
Dijual Rumah Mewah Diapit 2 AKses Tol - Cibubur Depok,Jakarta,Cibubur,70,60,790000000,130,Small
rumah baru kartini pasar baru termurah terjangkau,Jakarta,Kartini,38,21,608000000,59,Small
Dijual Rumah Baru Siap huni Sunter Jakarta Utara,Jakarta,Sunter,150,80,1500000000,230,Medium
Cluster Murah di Matraman Jakarta Timur,Jakarta,Utan Kayu,45,27,330000000,72,Small
jaul rumah murah di jakarta timur Rumah baru jalan rawakuning,Jakarta,Pulo Gebang,20,24,220000000,44,Small
"Dijual Murah Rumah / Ruko / Rukan / Gudang
Di daerah Glodok / Pinangsia / Kota / Mang...",Jakarta,Mangga Large,564,272,12500000000,836,Large
Rumah Cluster SHM  Cicilan Ringan DP SUKA SUKA DEKAT TOL  Cibubur,Jakarta,Cibubur,68,65,790000000,133,Small
Dijual Rumah PIK 2 Ukuran 10x15,Jakarta,Pantai Indah Kapuk,200,150,5100000000,350,Large
Di Jual Cepat Murahrumah Baru Hoek 2 Lantai Di Royal Residence Jak Tim,Jakarta,Cakung,114,250,2930000000,364,Medium
Dijual rumah 2lantai (siap huni),Jakarta,Joglo,75,50,350000000,125,Small
Dijual rumah siap huni dipesangrahan permai jakarta selatan,Jakarta,Pesanggrahan,110,140,2100000000,250,Medium
Rumah Siaphuni  Cukup Dp 10 Jt Free Semua Biaya2,Jakarta,Cibubur,56,140,700000000,196,Small
"DIJUAL CEPAT RUMAH DI KAWASAN ELIT (BELAKANG SCBD), COCOK U/ INVESTASI",Jakarta,Kebayoran Baru,204,182,14000000000,386,Large
Dijual Rumah Baru 2lt Termurah di Jakarta Barat,Jakarta,Cengkareng Timur,73,77,1000000000,150,Small
Rumah 2 lantai dekat tb simatupang,Jakarta,Fatmawati,75,105,1000000000,180,Small
"Dijual Rumah Modern Di Haji Saidi, Cipete. Lokasi Dekat Stasiun Mrt",Jakarta,Cipete Selatan,600,400,15500000000,1000,Large
"Dijual Rumah Modern Di Haji Saidi, Cipete. Lokasi Dekat Stasiun Mrt",Jakarta,Cipete Selatan,600,400,15500000000,1000,Large
Rumah Dijual Cepat Cantik Terawat Di Cinere Depok Dekat Lebak Bulus Jakarta,Jakarta,Lebak Bulus,240,280,4100000000,520,Large
"Rumah Lama Termurah Di Bawah Njop di Jati Padang, Pasar Minggu",Jakarta,Jati Padang,140,820,6200000000,960,Medium
DIJUAL CEPAT RUMAH TINGGAL SANGAT STRATEGIS DI KEBON JERUK NEGO,Jakarta,Kebon Jeruk,144,144,3500000000,288,Medium
TOBA LAKE VILLAS - RUMAH KONSEP RESORT DI TEPI DANAU ASYA JAKARTA GARDEN CITY,Jakarta,Cakung,506,465,9300000000,971,Large
Rumah Murah Pinggir Jalan cocok untuk Bisnis Usaha & Kost-an di Cibubur,Jakarta,Cibubur,240,240,1500000000,480,Large
"Dijual/Disewakan Rumah Klasik Bagus & Luas, 2 Lantai di Villa Gading Indah",Jakarta,Kelapa Gading,800,442,17900000000,1242,Large
PERUMAHAN Subsidi Terdekat Cibubur - PURI ASRI 3,Jakarta,Cibubur,30,60,178000000,90,Small
"DIJUAL RUMAH BARU AMERICAN CLASSIC, CEMPAKA PUTIH JAKARTA PUSAT",Jakarta,Cempaka Putih,412,308,12000000000,720,Large
RUMAH MEWAH CLASSIC PATRA KUNINGAN JAKARTA SELATAN,Jakarta,Kebayoran Baru,800,720,85000000000,1520,Large
Rumah dijual Di Kota Wisata 2 lantai semi Furnished,Jakarta,Kota Wisata,232,160,2800000000,392,Large
"CLUSTER KELIMUTU - ASYA JGC - STRATEGIS DEKAT TOL, MRT, LRT",Jakarta,Cakung,155,155,2700000000,310,Large
Rumah Dijual di dalam cluster bebas Banjir,Jakarta,Lenteng Agung,350,1454,15000000000,1804,Large
di jual lelang rumah pasar minggu,Jakarta,Pasar Minggu,180,445,2900000000,625,Large
Cluster Favorit Maninjau Asya Jakarta Garden City,Jakarta,Cakung,112,105,4600000000,217,Medium
Rumah Cluster Terbaru Gaya SCANDINAVIAN   - Harga 700jt Siap Huni Lokasi Premium,Jakarta,Jagakarsa,68,63,770000000,131,Small
"DIJUAL RUMAH SIAP HUNI DI AREA JL.CIPETE DALAM,CIPETE",Jakarta,Cipete,700,650,22000000000,1350,Large
Rumah Murah Jakarta SHM Tingkat 2 Lt Di Utan Kayu Matraman mulai 300jtan,Jakarta,Utan Kayu,28,15,330000000,43,Small
Rumah dijual hitung tanah dijaksel,Jakarta,SetiaBudi,90,150,2850000000,240,Small
Di Jual rumah bagus Full Furnished Lokasi Lenteng Agung - Jagakarsa Kota Jakarta,Jakarta,Lenteng Agung,94,94,1550000000,188,Medium
Cluster Sentarum @ASYA Jakarta Garden City -,Jakarta,Cawang,156,112,2900000000,268,Large
Bintaro Jaksel Jalan Merak,Jakarta,Bintaro,240,182,3100000000,422,Large
Dijual Rumah Modern Bagus 2 Lantai di Villa Gading Indah,Jakarta,Kelapa Gading,450,300,12500000000,750,Large
Darmawangsa Tenang jln lebar  hitung tanah,Jakarta,Kebayoran Baru,579,597,32000000000,1176,Large
"Dijual Cepat Rumah lama siap Huni Di area Permata Hijau,Jaksel",Jakarta,Permata Hijau,600,1290,45000000000,1890,Large
Modern Villa House Area Cilandak Siap Huni dan Lingkungan Tenang,Jakarta,Cilandak,500,459,14500000000,959,Large
"PANTAI MUTIARA,HARGA NEGO",Jakarta,,800,600,20000000000,1400,Large
"7 Bedrooms Rumah Cibubur, Jakarta Timur, DKI Jakarta",Jakarta,Cibubur,410,411,2850000000,821,Large
Rumah Siaphuni Di Cibubur,Jakarta,Cibubur,87,69,750000000,156,Small
rumah baru murah disini  fuul minimalis,Jakarta,Kayu Manis,36,20,400000000,56,Small
Dijual Rumah Murah Jl Martimbang Raya Sinabung Kebayoran Baru Jaksel,Jakarta,Kebayoran Baru,200,264,10000000000,464,Large
Tinggal 4 Unit Rumah Cluster 2 Lantai Termurah Strategis Cimanggis Depok SHM,Jakarta,Lenteng Agung,65,60,770000000,125,Small
Midland  Smart Cluster  Warakas Harga Mulai Dari 299Juta,Jakarta,Warakas,21,21,299000000,42,Small
Di Jual Rumah Mewah 2 Lantai di Sunter Jaya Jakarta Utara,Jakarta,Sunter Jaya,530,459,8100000000,989,Large
Rumah baru dua lantai di utan kayu,Jakarta,Matraman,40,21,505000000,61,Small
NEW TOWN HOUSE SIAP HUNI DI JL M KAHFI 1,Jakarta,Jagakarsa,130,77,1525000000,207,Medium
Di jual rumah minimalis murah dan bs KPR Developer,Jakarta,Lubang Buaya,40,40,450000000,80,Small
Rumah Dijual Di Dharmawangsa Prapanca Kebayoran Baru Jakarta Selatan,Jakarta,Kebayoran Baru,350,647,50000000000,997,Large
Dijual rumah baru renovasi Durens awit jakarta timur,Jakarta,Duren Sawit,160,160,2200000000,320,Large
BELI PASTI UNTUNG! JUAL SECEPAT KILAT Rumah di Lokasi Prime Kebayoran Baru,Jakarta,Kebayoran Baru,200,237,6500000000,437,Large
Rumah Baru Minimalis Metland Puri,Jakarta,Kembangan,120,120,2500000000,240,Medium
Rumah Kebayoran Baru,Jakarta,Kebayoran Baru,500,324,39000000000,824,Large
Rumah kosan (kontrakan) 22 pintu,Jakarta,Semper Timur,300,180,2500000000,480,Large
"Dijual Cepat Rumah dan Kos-kosan Lokasi Strategis, Luas, dan Asri",Jakarta,Bintaro,500,891,15000000000,1391,Large
RUMAH MURAH DI KALI BARU,Jakarta,Senen,38,21,451000000,59,Small
Rumah murah pulogebang,Jakarta,Pulo Gebang,20,24,220000000,44,Small
"Dijual rumah murah asri minimalis, strategis Ciseeng 5jt all in",Jakarta,Kebagusan,32,65,260000000,97,Small
Rumah Mewah Ada Rooftop Dalam Cluster Rumah Cira Cipinang,Jakarta,Cipinang,300,205,6100000000,505,Large
jual bangunan bekas rumah kost 3 lantai 40 kamar (hitung jual tanah),Jakarta,Utan Kayu Utara,639,243,3700000000,882,Large
Cluster Mewah dan Murah di Kwitang Raya,Jakarta,,71,45,1500000000,116,Small
DI JUAL RUMAH MEWAH 2 LANTAI DAERAH CIPINANG,Jakarta,Cipinang,68,33,724850000,101,Small
Dandelion CIBUBUR - 700Jutaan PROMO ALL IN dekat Stasiun LRT - PREMIUM AREA,Jakarta,Cibubur,68,60,770000000,128,Small
Rumah Cantik Terbaru SCANDINAVIAN 700jutaan ALL IN dekat Tol & Stasiun HOT DEAL,Jakarta,Cijantung,68,60,770000000,128,Small
Dijual murah rumah diwilayah Jakarta Barat (Daerah Kebub Jeruk),Jakarta,Kebon Jeruk,180,105,1750000000,285,Large
DIJUAL RUMAH HOEK TEBET JAKARTA SELATAN,Jakarta,Tebet Timur,300,235,6500000000,535,Large
Jual cepat kos tanjung duren..jarang ada..nego sampai jadi,Jakarta,Tanjung Duren,180,78,3300000000,258,Large
Perumahan Mahakam Konsep Etic 3 Lantai Jakarta Garden City,Jakarta,Cakung,63,75,1900000000,138,Small
Dijual Rumah Baru View Gunung Dekat Toll Daerah Asri by Kalindoland,Jakarta,Senen,36,115,665880000,151,Small
DIJUAL RUMAH ASRI AKSES MOBIL CIBUBUR BULAK RINGIN,Jakarta,Cibubur,60,89,650000000,149,Small
RUMAH MURAH SIAP HUNI PIK 2 Cluster Pasadena Spring,Jakarta,Pluit,110,60,1300000000,170,Medium
Rumah kavling di pulogebang,Jakarta,Pulo Gebang,20,24,220000000,44,Small
Bali resort Tangerang haus++,Jakarta,Kalideres,80,60,898400000,140,Small
"Dijual Rumah Kolonel Sugiono siap huni, Nyaman buat tinggal bisa jadi 2 ruko",Jakarta,Duren Sawit,133,133,1980000000,266,Medium
Rumah murah asri minimalis modern 5jt all in,Jakarta,Joglo,42,84,402000000,126,Small
Jual butuh dan murah rumah bedeng daerah Gandaria I.,Jakarta,Gandaria,36,36,400000000,72,Small
Dijual Rumah Duren Sawit Siap Huni,Jakarta,Duren Sawit,123,102,1750000000,225,Medium
rumah baru 2lantai mewah termurah laris manis,Jakarta,Cipinang,73,35,760000000,108,Small
PREMIUM AREA - Dandelion Estate Hunian Scandinavian 700jutaan FREE BIAYA BIAYA,Jakarta,Cibubur,68,60,770000000,128,Small
Rumah Modern Jakarta SHM Tingkat 2 Lt Di Cipinang Kb Nanas Jaktim Mulai 700jtan,Jakarta,Cawang,68,33,724000000,101,Small
Metland Cyber Cluster Northbend Harga Perdana Paling Murah Se-Jakarta,Jakarta,Puri Indah,1,1,2200000000,2,Small
Virya Semanan Tipe 7,Jakarta,,166,140,3016000000,306,Large
Dijual Rumah Lokasi Terogong Cilandak,Jakarta,Cilandak,864,1057,39000000000,1921,Large
"RUMAH 2 LANTAI DALAM CLUSTER EXCLUSIVE, STRATEGIS DEKAT TOL SETU DAN TOL CEGER",Jakarta,Bambu Apus,112,139,2581000000,251,Medium
DIJUAL RUMAH LAMA DI HANG LEKIR,Jakarta,Kebayoran Baru,250,200,12000000000,450,Large
Rumah dlm cluster 6M nego smpai deal  di Kebagusan Jakarta Selatan,Jakarta,Kebagusan,225,306,6000000000,531,Large
(RMD) RUMAH MINIMALIS SUBSIDI DEKAT STASIUN MAJA@PERMATA MUTIARA MAJA,Jakarta,Radio Dalam,27,60,150000000,87,Small
Rumah Djawa Klasik Modern Lebak Bulus Jak Sel,Jakarta,Lebak Bulus,900,1025,22000000000,1925,Large
Dijual Rumah Modern Minimalis Dalam Townhouse Di Belakang Citos Cilandak Jakarta Sela...,Jakarta,Cilandak,433,157,8000000000,590,Large
PRIVATE CLUSTER- Rumah/Hunian Terbaru Dekat PINTU TOL CIBUBUR 700 jutaan ALL IN,Jakarta,Cipayung,68,60,770000000,128,Small
Rumah unit pojokan siap huni & indent,Jakarta,Jagakarsa,114,75,1250000000,189,Medium
DIJUAL Rumah brandnew siap huni di kawasan berkembang WISTERIA,Jakarta,Cakung,79,84,2200000000,163,Small
Dijual Rumah Cluster Oxalis Tahap 2 Termurah Se Jakarta Barat,Jakarta,Kembangan,70,55,1500000000,125,Small
Rumah 2 lantai Strategis Bebas Banjir Daerah Lenteng Agung,Jakarta,Lenteng Agung,95,77,1700000000,172,Medium
D'LAPAN TOWNHOUSE,Jakarta,Pasar Rebo,48,41,710000000,89,Small
Jual rumah tingkat bisa usaha kpr dimunjul cipayung jakarta timur,Jakarta,Cipayung,75,80,655000000,155,Small
Dijual Rumah Elegan lokasi strategis di Cempaka Putih Tengah,Jakarta,Cempaka Putih,520,450,8000000000,970,Large
Rumah cantik minimalis hnya 300 jutaan lokasi dkat dengan suntetmall,Jakarta,Tanjung Priok,24,24,325500000,48,Small
SISA 1 UNIT LUXURY CLASSIC MODERN HOUSE 3 LANTAI DALAM CLUSTER DI JAGAKARSA JAKARTA S...,Jakarta,Jagakarsa,140,72,1900000000,212,Medium
RUMAH DIJUAL DI PONDOK AREN BINTARO FREE SEMUA BIAYA BIAYA,Jakarta,Bintaro,92,72,1300000000,164,Medium
Rumah Ready On Progres Murah Di Jatikramat Bekasi Dekat Tol,Jakarta,Jatinegara,80,65,837400000,145,Small
Rumah Murah Jakarta SHM Tingkat 2 Lt Di Kemayoran JakPus Mulai 300jtan,Jakarta,Kemayoran,33,18,400000000,51,Small
Dijual rumah di area bintaro pondok aren masuk mobil,Jakarta,Joglo,80,40,550000000,120,Small
RUMAH BARU MODERN MINIMALIS DI CIJANTUNG KALISARI JAKARTA TIMUR,Jakarta,Kalisari,90,66,1150000000,156,Small
Rumah Murah Jakarta SHM Tingkat 2-3 Lantai Sertifikat SHM Hak Milik Lokasi Strategis,Jakarta,Kebon Jeruk,62,32,825800000,94,Small
RUMAH DI JUAL DI JAGAKARSA D'CASSA 5 JAGAKARSA NEGO DILOKASI,Jakarta,Jagakarsa,36,52,700000000,88,Small
Rumah dijual Jl. Dharmawangsa Panglima Polim Prapanca kebayoran baru jakarta sel,Jakarta,Kebayoran Baru,350,657,50000000000,1007,Large
RUMAH 2 LANTAI BISA KPR DI JAGAKARSA JAKARTA SELATAN,Jakarta,Jagakarsa,110,63,1450000000,173,Medium
Rumah Cantik design Modern di Cibubur,Jakarta,Cibubur,45,65,499000000,110,Small
Virya Semanan Tipe 6,Jakarta,,136,120,2548000000,256,Medium
"KODE :16563(Si/Dj) Rumah Dijual Tamansari, Luas 106 Meter",Jakarta,Taman Sari,270,106,6000000000,376,Large
Jual Murah Rumah 2 Lantai Dalam Komplek Cilandak Jakarta Selatan,Jakarta,Cilandak,350,335,10000000000,685,Large
Dijual rumah dalam komplek di ulujami pesanggrahan Jaksel,Jakarta,Pesanggrahan,200,140,1900000000,340,Large
RUMAH MURAH DUA LANTAI DI CIRACAS JAKARTA TIMUR,Jakarta,Ciracas,140,70,1000000000,210,Medium
"DI JUAL Rumah bagus di daerah Kenanga Ampera, aman, nyaman dan tenang. siap huni",Jakarta,Ampera,314,311,10500000000,625,Large
Dijual Cepat Rumah Dharmawangsa Kebayoran Baru Murah Turun Harga,Jakarta,Kebayoran Baru,558,558,19000000000,1116,Large
Rumah murah di cipinang,Jakarta,Pulo Gadung,66,36,1140000000,102,Small
Dijual Murah Rumah Cluster Nyaman dan Adem di Cipayung Jak-tim,Jakarta,Cipayung,36,115,950000000,151,Small
Rumah Semi RE 42/120 Murah,Jakarta,,42,120,460000000,162,Small
Dijual Rumah di Lebak Bulus Cilandak,Jakarta,Lebak Bulus,400,440,9750000000,840,Large
RUMAH BAGUS MURAH LT 120 KOTA WISATA CIBUBUR BOGOR,Jakarta,Kota Wisata,150,120,1250000000,270,Medium
New town house dekat transmart cilandak,Jakarta,Cilandak,200,96,3550000000,296,Large
Rumah Baru Brand New Menteng 3 lantai ada Pool Lift Mewah Dijual Fully Furnished,Jakarta,Menteng,1200,474,73000000000,1674,Large
"DI JUAL Rumah tua di daerah duren tiga selatan, harga dibawah NJOP Nego",Jakarta,Duren Tiga,200,326,4600000000,526,Large
Rumah design Modern FREE BPHTB di Cibubur Cikeas Bogor,Jakarta,Cibubur,85,81,828000000,166,Small
RUMAH EXCLUSIVE PERMATA HIJAU JAKARTA SELATAN,Jakarta,Permata Hijau,300,500,13500000000,800,Large
Jual cepat Rumah di kebon jeruk Villa Kelapa Dua,Jakarta,Kebon Jeruk,130,108,2500000000,238,Medium
"Dijual Rumah Siap Huni di Sunter Agung, Seberang Sunter Mall",Jakarta,Sunter Agung,250,150,4200000000,400,Large
"Rumah baru 2 lantai di pinggir Jalan utama, bebas banjir KPR BSI",Jakarta,Kalisari,100,75,1280000000,175,Medium
Rumah Modern Jakarta SHM Tingkat 2Lt Di Cempaka Putih Jakpus,Jakarta,Cempaka Putih,68,36,1377000000,104,Small
Rumah murah strategis di jakarta selatan 9 menit dari pintu tol slipi,Jakarta,Grogol Utara,285,156,3800000000,441,Large
Rumah kios dijual dijakarta pusat,Jakarta,Johar Baru,66,70,1150000000,136,Small
Bintaro Jaya Sektor 1 Jl Merak 182m� Nyaman,Jakarta,Bintaro,240,182,3100000000,422,Large
Rumah Lux di Ragunan,Jakarta,Ragunan,700,1060,23000000000,1760,Large
Jual Rumah Murah Di Jagakarsa Jakarta Selatan dekat Andara,Jakarta,Jagakarsa,120,61,1250000000,181,Medium
DI Jual Rumah Komplek Pertamina,Jakarta,,600,699,20000000000,1299,Large
Rumah 2Lantai Dp 4jutaan,Jakarta,,39,60,680000000,99,Small
Rumah Dijual Siap Huni di Pasar Rebo,Jakarta,,150,200,2000000000,350,Medium
Dijual Cepat ! Rumah 3 BR kawasan Jakarta Timur - Kolam Renang,Jakarta,Rawamangun,200,529,18000000000,729,Large
"Dijual Rumah Cluster Minimalist AYALIS RESIDENCE Menteng, Jakarta Pusat",Jakarta,Menteng,40,23,750000000,63,Small
Dijual cepat Rumah super mewah interkon..,Jakarta,Kembangan,2100,778,33000000000,2878,Large
Rumah di kebon bawang tanjung priok jakarta utara,Jakarta,Tanjung Priok,250,172,4200000000,422,Large
Rumah kost dijual dijakarta pusat,Jakarta,Menteng,170,57,1800000000,227,Large
PREMIUM AREA - Cluster Terbaru 700jutaan SELANGKAH AKSES STASIUN & TOL - ALL IN,Jakarta,Ciracas,68,63,770000000,131,Small
Hunian Mewah Dilokasi Mewah,Jakarta,Cempaka Putih,64,34,1300000000,98,Small
Rumah Subsidi Cileungsi-Bogor Puri Asri 3 PROMO DP 5 JT GRATIS BIAYA PROSES,Jakarta,Cibubur,30,60,178000000,90,Small
The Lagoon Park Bukit Golf Riverside Cibuburr,Jakarta,Cibubur,63,60,1125213000,123,Small
rumah cantik 2 lantai di jakarta selatan,Jakarta,Jagakarsa,150,108,2150000000,258,Medium
Rumah murah dan minimalis,Jakarta,Cempaka Putih,68,36,1337500000,104,Small
Rumah Murah Cipinang Rawamangun,Jakarta,Cipinang,66,36,1140000000,102,Small
CLUSTER Terbaru NYAMAN dan STRATEGIS Harga 700jutaan ALL IN - Cimanggis Depok,Jakarta,Jagakarsa,68,60,770000000,128,Small
Termurah Di CIMANGGIS DEPOK - Scandinavia 2LT Terbaru Cicilan Mulai 6jutaan,Jakarta,Cipayung,68,60,770000000,128,Small
Rumah di Jual Jagakarsa Minimalis Classic Rooftop Luas Dekat TOL Jagakarsa,Jakarta,Jagakarsa,200,96,2600000000,296,Large
Rumah mewah di jakarta barat 10 menit dari stasiun,Jakarta,Semanan,136,120,2550000000,256,Medium
"Di Jual Rumah Cluster Minimalist AYALIS RESIDENCE Kwitang, Senen,  Jakarta Pusat",Jakarta,Kwitang,42,23,750000000,65,Small
"Dijual Rumah Luas, harga Menarik, Strategis, tomang",Jakarta,Tomang,203,135,4000000000,338,Large
Rumah Mewah 3 Lantai Cluster Magnolia - Puri Botanical Residence,Jakarta,Kembangan,510,838,22000000000,1348,Large
Rumah siap huni Sunter Danau,Jakarta,Sunter,324,108,2700000000,432,Large
"Rumah Dan Kos Kosan Dekat Perkantoran, Jalan Raya, Toll, Dalam Komplek  Pancoran",Jakarta,Pancoran,770,455,18500000000,1225,Large
Dijual Rumah Kota Wisata Full Furnished Istimewa Siap Huni,Jakarta,Cibubur,250,180,2500000000,430,Large
Dijual Rumah Kota Wisata Full Furnished Istimewa Siap Huni,Jakarta,Cibubur,250,180,2500000000,430,Large
rumah subsidi pesona kahuripan,Jakarta,Legenda Wisata,30,60,168000000,90,Small
Rumah Mewah Area Premium di Cbd Mega Kuningan Jakarta Selatan,Jakarta,Kuningan,1150,708,51000000000,1858,Large
Hunian Luxurious Dalam Cluster,Jakarta,Jagakarsa,240,126,2700000000,366,Large
Hunian Mewah di Komplek Kavling DKI,Jakarta,Jagakarsa,220,135,3500000000,355,Large
"Rumah minimalis 2 lantai di Petukangan Utara, Jaksel",Jakarta,Pesanggrahan,214,323,3100000000,537,Large
"Turun hargaaaaa, BU",Jakarta,Cengkareng,300,250,2300000000,550,Large
Rumah Golf Island PIK Mozart,Jakarta,Pantai Indah Kapuk,350,250,11500000000,600,Large
Rumah Murah Siap Huni di Cluster Royal Residence Jakarta Timur,Jakarta,Cakung,120,90,1650000000,210,Medium
Rumah Megah 2 Lantai Tanah 247 M2 Murah di Duren Sawit,Jakarta,Duren Sawit,200,247,2700000000,447,Large
RUMAH MEWAH BERGAYA APARTHAOUSE DAERAH CEMPAKA PUTIH TENGAH,Jakarta,Cempaka Putih,98,34,1411462500,132,Medium
Rumah Minimalis Jagakarsa Jakarta Selatan,Jakarta,Jagakarsa,110,119,1250000000,229,Medium
RUMAH BARU STRATEGIS DI CILANDAK DEKAT TRANSMART CILANDAK JAKARTA SELATAN,Jakarta,Cilandak,110,62,1825000000,172,Medium
RUMAH BARU MINIMALIS MODERN CLASSIC DI CONDET JAKARTA TIMUR,Jakarta,Condet,115,84,1850000000,199,Medium
Rumah Modern Baru Full Furnish Strategis Villa Tomang Mas Duri Kepa 10x15m,Jakarta,Duri Kepa,150,150,3900000000,300,Medium
RUMAH DENGAN 2 KAMAR MINIMALIS DP 18 BULAN DI KOTA,Jakarta,Kalideres,31,60,517000000,91,Small
Dijual Cepat Dan Murah Rumah  Cantik Siap Di Pesanggrahan Kebayoran Lama Jakarta,Jakarta,Pesanggrahan,335,240,4250000000,575,Large
"DIJUAL CEPAT RUMAH 1 1/2 LANTAI AKSES MOBIL/TRUCK,CIPAYUNG,JAKTIM",Jakarta,Cipayung,178,178,1400000000,356,Large
Rumah mewah di cluster Margasatwa Cilandak,Jakarta,Cilandak Timur,500,603,13000000000,1103,Large
PREMIUM AREA - PRIVAT Cluster Terbaru Style Scandinavian 2 lantai FREE BIAYA2,Jakarta,Cijantung,68,63,770000000,131,Small
"Dijual Rumah Baru Minimalis 3lt di Cengkareng, Jakarta Barat",Jakarta,Cengkareng,140,60,1750000000,200,Medium
Dijual Rumah Bagus Siap Huni Di Jl. Mpr Cipete - Cilandak Barat,Jakarta,Cilandak,340,182,7700000000,522,Large
Rumah Mewah 3 Lantai Bagus Banget di Kebayoran Baru,Jakarta,Kebayoran Baru,500,831,34000000000,1331,Large
FOR SALE PATRA KUNINGAN,Jakarta,Kuningan Timur,400,440,28000000000,840,Large
Rumah cantik jln Depan Rumah 10meteran Harga nego,Jakarta,Jagakarsa,140,126,2500000000,266,Medium
Dijual rumah siap huni area brawijaya,Jakarta,Kebon Baru,600,822,50500000000,1422,Large
Jual cepat rumah mewah Eropa Classic kebagusan,Jakarta,Kebagusan,250,102,3500000000,352,Large
Hunian cantik dalam cluster jagakarsa,Jakarta,Jagakarsa,130,75,1625000000,205,Medium
Di jual rumah murah termurah 2 lantai daerah kayu jakarta timur manis,Jakarta,Kayu Manis,37,25,485000000,62,Small
"Dijual rumah strategis, recommended banget untuk kost-kost an di Cempaka Putih",Jakarta,Cempaka Putih,400,200,3400000000,600,Large
jual rumah murah di kebayoran baru cocok di jadikan Investasi dan untuk kantor,Jakarta,Kebayoran Baru,1200,557,19000000000,1757,Large
Dijual Rumah ICONIC di Jakarta timur,Jakarta,Duren Sawit,90,146,3900000000,236,Small
Rumah Pinggir Jalan NJOP,Jakarta,Pancoran,180,100,5000000000,280,Large
Rumah minimalis modern 2 lantai,Jakarta,,45,33,1140000000,78,Small
Hunian Mewah Dan Murah Dikawasan Strategis Jakarta Pusat,Jakarta,Senen,38,20,400000000,58,Small
Rumah Murah di cempaka putih,Jakarta,Cempaka Putih,100,35,1638000000,135,Medium
The Lagoon Park Bukit Golf Riverside Cibubur type Evia,Jakarta,Cibubur,40,60,886206908,100,Small
rumah baru jagakarsa,Jakarta,Jagakarsa,135,93,2200000000,228,Medium
Dijual rumah Gaharu 2 Cipete kebayoran baru jakarta selatan,Jakarta,Kebayoran Baru,396,154,7500000000,550,Large
Rumah Tinggal Tingkat Minimalis Terbaik Siap Huni Dengan Harga Murah,Jakarta,Kalideres,103,180,1300000000,283,Medium
Rumah dijual Nempel Bintaro dan Ciledug Tangerang,Jakarta,Pesanggrahan,92,72,1300000000,164,Medium
Rumah Bersih Terawat Citra Garden 1 ext 8x20m,Jakarta,Kalideres,180,160,2250000000,340,Large
"Dijual Rumah Luas, Nyaman dan Strategis di Jakarta Barat",Jakarta,Cengkareng Barat,250,324,5500000000,574,Large
RUMAH MURAH SELATAN JAKARTA,Jakarta,TB Simatupang,64,60,1300000000,124,Small
"Rumah Modern Minimalis di Jagakarsa, Jakarta Selatan",Jakarta,Jagakarsa,130,75,1650000000,205,Medium
"dijual Rumah Pluit karang Molek 234 meter, 20 juta/meter",Jakarta,Muara Karang,234,234,4500000000,468,Large
PREMIUM AREA - Hunian/Rumah Baru Scandinavian DP suka2 Cicilan Mulai 6 jutaan,Jakarta,Condet,68,60,770000000,128,Small
"DIJUAL CIMANGGIS GOLF ESTATE LAUNCH CLUSTER BARU NAHARA HARGA MULAI DARI 1,5M",Jakarta,Cibubur,89,85,1500000000,174,Small
Rumah Mewah Duren Sawit Jakarta Timur,Jakarta,Duren Sawit,1000,763,23000000000,1763,Large
Dijual Rumah Nyaman di lingkungan prime Premier Riviera Rawamangun,Jakarta,Klender,135,138,3850000000,273,Medium
Paling Murah rumah di Villa Kelapa Dua,Jakarta,Kebon Jeruk,130,108,2500000000,238,Medium
Metland Menteng Tipe Canna,Jakarta,Cakung,97,160,3069807488,257,Medium
Cluster Lavender Tipe B � Puri Botanical,Jakarta,Kembangan,65,60,1990000000,125,Small
Rumah Di Cipayung Jakarta Timur,Jakarta,Cipayung,140,103,1500000000,243,Medium
rumah baru mewah termurah lingkungan bebas banjir,Jakarta,Cempaka Putih,160,68,2280000000,228,Large
"Rumah Terlaris lokasi strategis,Cilangkap�cipayung,jakarta timur",Jakarta,Cilangkap,70,97,1100000000,167,Small
"Rumah Mewah Pik2 Cluster Denver, Over Credit, Sisa Cicilan 49x",Jakarta,Pantai Indah Kapuk,104,75,2571163623,179,Medium
"Townhouse Cilangkap Jakarta. Dekat  puskesmas Cipayung, 12mnt gerbang tol Setu",Jakarta,Cilangkap,70,50,650000000,120,Small
Rumah siap huni dalam komplek CIPETE Jakarta Selatan,Jakarta,Cipete,300,320,12500000000,620,Large
Dijual Rumah siap huni di perumahan pondok Indah,Jakarta,Pondok Indah,650,560,27000000000,1210,Large
RUMAH MURAHTANPA DP Di BEKASI.,Jakarta,Pasar Rebo,36,60,430000000,96,Small
JUAL RUMAH TEBET,Jakarta,Tebet,273,181,7000000000,454,Large
RUMAH MURAH CLASSIC TERJANGKAU DEKAT MALL DAN RUMAH SAKIT,Jakarta,Cipayung,31,60,452880000,91,Small
"Di Jual Rumah Indent 2,5 Lantai Mewah Area Condet Pasar Rebo Jakarta Timur",Jakarta,Pasar Rebo,170,127,2695000000,297,Large
Jual Townhouse Murah Ready di Cipayung,Jakarta,Cipayung,110,90,1950000000,200,Medium
Rumah design industrial di matoa dekat 3 gate tol di ciganjur jagakarsa,Jakarta,Ciganjur,160,107,1900000000,267,Large
Jual Cepat Rumah Type 38/180 di perumahan Citra Indah Citu,Jakarta,Cibubur,38,180,460000000,218,Small
RUMAH DI JUAL DI JAGAKARSA D'CASSA 5 JAGAKARSA NEGO SAMPAI JADI,Jakarta,Jagakarsa,36,52,750000000,88,Small
modern classic,Jakarta,Jagakarsa,225,96,3100000000,321,Large
Rumah BGM PIK 8X15 Termurah (Dekat Pasar Freshmarket Pik),Jakarta,Pantai Indah Kapuk,200,120,4500000000,320,Large
For Sale House Scandinavian at Cilandak,Jakarta,Cilandak,127,200,4750000000,327,Medium
Dijual murah BU,Jakarta,Kalideres,150,255,5200000000,405,Medium
RUMAH DIJUAL MURAH DI PRIOK JAKARTA UTARA HARGA NEGO SAMPAI JADI,Jakarta,Tanjung Priok,108,295,4000000000,403,Medium
"Taman Grisenda PIK, 12x20, 2� Lantai, Hadap Selatan.",Jakarta,Pantai Indah Kapuk,400,240,8500000000,640,Large
CITRA GARDEN 2 JAKARTA BARAT JUAL CEPAAT SEMI FURNISHED,Jakarta,Kalideres,480,108,4200000000,588,Large
RUMAH JAKARTA TIMUR BISA KPR,Jakarta,Ciracas,61,50,745000000,111,Small
Rumah mewah tb simatupang di pasar minggu Jaksel,Jakarta,Pasar Minggu,500,732,22000000000,1232,Large
Jual Cepat Rumah 2-lantai Daerah Kalibata Dekat Stasiun Duren,Jakarta,Kalibata,405,505,17500000000,910,Large
Di Jual Cepat Rumah Private Pool Kemang Terawat Rapi Siap Huni,Jakarta,Cilandak,640,446,13500000000,1086,Large
Angel Residence tipe Uriel,Jakarta,Kalideres,70,64,1877000000,134,Small
Di Jual Rumah ataw kosan,Jakarta,Palmerah,222,152,2200000000,374,Large
"Dijual Rumah Asri, tanah luas di Damarsari , Jati Padang, Jakarta Selatan",Jakarta,Pasar Minggu,200,280,6300000000,480,Large
Rumah Premium 2LT Harga 700jutaan LOKASI DEKAT dengan Tol & Stasiun. Cibubur,Jakarta,Cijantung,68,60,770000000,128,Small
Cluster Lavender Tipe A2 � Puri Botanical,Jakarta,Kembangan,66,60,2000000000,126,Small
RUMAH 3 Lantai di KALIBATA Jakarta selatan,Jakarta,Kalibata,190,81,5000000000,271,Large
Rumah Kualitas Premium Siap Huni Bonus Interior Mewah Dekat ke TOL Bambu Apus,Jakarta,Cipayung,140,100,2475000000,240,Medium
DI JUAL Rumah modern siap huni di dalam komplek di daerah Kemang Dalam.,Jakarta,Kemang,350,392,15000000000,742,Large
Rumah Mewah di Danau Indah Raya,Jakarta,Sunter Jaya,900,760,23000000000,1660,Large
"rumah townhouse cibubur, belakang raffless hills",Jakarta,Cibubur,98,73,1300000000,171,Medium
Cluster Lavender Tipe A1 � Puri Botanical,Jakarta,Kembangan,62,50,1775000000,112,Small
Dijual Rumah tanjung duren untuk kos-kosan strategis segitiga emas,Jakarta,Tanjung Duren,148,156,3650000000,304,Medium
Rumah Di Kolonel Sugiono Jakarta Timur,Jakarta,Duren Sawit,133,133,1980000000,266,Medium
HARGA PROMO.RUMAH 3 LANTAI DEKAT KOMPLEK BRIMOB POLRI PEJATEN BARAT,Jakarta,Pejaten,100,40,975000000,140,Medium
"RUMAH MEWAH 2,5 LANTAI ADA KOLAM RENANG DI JAGAKARSA JAKARTA SELATAN",Jakarta,Jagakarsa,150,96,1950000000,246,Medium
For sale Cluster at Pesanggrahan Jaksel,Jakarta,Pesanggrahan,165,91,2200000000,256,Large
Rumah 2 Lantai di Jakarta barat,Jakarta,Kalideres,60,48,1500000000,108,Small
Di Jual Rumah Mewah di Cilandak Kakao,Jakarta,Cilandak,444,717,11000000000,1161,Large
"Di jual Rumah Tua, Hitung Tanah Saja di Jakarta Pusat, Senen, Kramat",Jakarta,Senen,192,208,3200000000,400,Large
RUMAH 3 LANTAI AKSES 2 MOBIL PINGGIR JALAN RAYA 2 MENIT KE TOL DESARI BRIGIF JAGAKARS...,Jakarta,Jagakarsa,170,100,2890000000,270,Large
"RUMAH 2,5 LANTAI ( ROOFTOP ) DALAM CLUSTER DI JAGAKARSA JAKARTA SELATAN",Jakarta,Jagakarsa,200,93,2550000000,293,Large
Dijual. Rumah Tua Hitung Tanah Di Daerah Kemang. Harga Turun Dibawah Njop.,Jakarta,Kemang,500,792,18500000000,1292,Large
CLUSTER TANPA DP,Jakarta,Jagakarsa,45,70,598500000,115,Small
Rumah Dijual Jakarta Barat,Jakarta,Meruya,205,120,1900000000,325,Large
Dijual Rumah Seafront Ancol Jakarta Utara,Jakarta,Ancol,326,144,6800000000,470,Large
Rumah baru 2lantai di ciracas,Jakarta,Ciracas,63,43,799000000,106,Small
Dijual rumah mewah kawasan Elit Menteng Residence Bintaro,Jakarta,Bintaro,900,1400,37500000000,2300,Large
JUAL RUMAH SUMUR BATU,Jakarta,Sumur Batu,300,252,6200000000,552,Large
"Pik, dijual rumah TERMURAH STOCK TERAKHIR Lt 6x15m2 jarang ada Rp3,5M",Jakarta,Pantai Indah Kapuk,90,90,3500000000,180,Small
rumah baru jagakarsa,Jakarta,Jagakarsa,120,88,2100000000,208,Medium
"Dijual. Townhouse Di Daerah Strategis Bangka, Kemang. Harga Menarik",Jakarta,Bangka,290,198,6750000000,488,Large
Rumah 2 lantai Cipaku Kebayoran Baru dekat SCBD Sudirman Senopati Dijual 40M,Jakarta,Kebayoran Baru,500,714,40000000000,1214,Large
Rumah siap huni lokasi strategis lingkungan nyaman di cluster Cilandak,Jakarta,Cilandak Timur,568,226,11561400000,794,Large
DIJUAL RUMAH AREA GANDARIA ~ LT/LB 185/195 ~ MODERN CLASSIC HOUSE ~ BEST PRICE!,Jakarta,Kebayoran Baru,195,185,4900000000,380,Large
DIJUAL RUMAH CILANDAK ~ LT/LB 200/127 ~ RUMAH MODERN SCANDINAVIAN,Jakarta,Cilandak,127,200,4750000000,327,Medium
"Jarang Ada, Rumah di Gading Pandawa Kelapa Gading dekat dengan LRT",Jakarta,Kelapa Gading Timur,280,240,7500000000,520,Large
Dijual rumah baru minimalais modern termewah,Jakarta,Cipinang,84,64,2168000000,148,Small
Townhouse Islami Premium 3 Lantai di Cibubur Tanpa Riba dekat RSUD Ciracas,Jakarta,Ciracas,120,102,1822500000,222,Medium
Di Jual Rumah di Rawamangun Lokasi Strategis Bebas Banjir,Jakarta,Rawamangun,400,135,7000000000,535,Large
town house  graha baru veteran bintaro,Jakarta,Bintaro,450,527,13900000000,977,Large
"Dijual Rumah Cantik, Lantai Tingkat dan Lokasi Strategis di Cempaka Putih Permai",Jakarta,Cempaka Putih,194,127,3800000000,321,Large
rumah bebas banjir kpr tanpa dp 0%,Jakarta,Cibubur,45,72,593500000,117,Small
Di Jual Rumah di Kelapa Gading Timur Lokasi Komersil Strategis,Jakarta,Kelapa Gading,295,320,9000000000,615,Large
Rumah Baru Perum JGC Cluster South Thames Blok J12 / 62 Jaktim Sudah Sertifikat,Jakarta,Cakung,62,90,1725000000,152,Small
Jual Rumah Darmawangsa Kebayoran Baru Lokasi Strategis,Jakarta,Kebayoran Baru,300,984,48000000000,1284,Large
Rumah murah hitung tanah harga dibawah njop jln. S Parman Jakbar Slipi,Jakarta,Palmerah,800,1258,52500000000,2058,Large
springhill golf residences,Jakarta,Kemayoran,400,120,6000000000,520,Large
Cluster Strategis Terbaru Dekat Tol & Stasiun Cibubur Harga 700 jutaan ALL IN,Jakarta,Condet,68,60,770000000,128,Small
Dijual Rumah Minimalis 2lt luas 120m� di Metland Menteng Cakung Jakarta Timur,Jakarta,Cakung,119,120,1700000000,239,Medium
Dijual Rumah Artistic Di Lokasi Mewah,Jakarta,Cakung,156,112,4000000000,268,Large
Rumah Etnik Asri Hijau kawasan Ragunan Jakarta Selatan,Jakarta,Ragunan,320,550,7500000000,870,Large
Rumah cluster  mewah cawang residence,Jakarta,Cawang,110,65,1750000000,175,Medium
Rumah Dengan Halaman Luas Nyaman Dan Asri Di Kawasan Cilandak Ragunan,Jakarta,Ragunan,500,1000,17000000000,1500,Large
Rumah di kemang jaya apartemen taman.,Jakarta,Kemang,450,400,13500000000,850,Large
Turun harga  Di jual rumah di Semper Jakarta Utara,Jakarta,Semper,154,354,2500000000,508,Large
Di Jual Rumah Bagus Siap Huni Di Palmerah,Jakarta,Palmerah,1000,436,12500000000,1436,Large
Di jual rumah 2 dan 3 lantai mewah dan Moderent daerah Cipinang baru raya,Jakarta,Cipinang,99,84,2168000000,183,Medium
Rumah 2 lantai layak huni di daerah duri mas duri Kepa Jakarta barat,Jakarta,Duri Kepa,120,89,2250000000,209,Medium
Dijual Rumah Murah Jakarta Strategis Cemp Putih Tengah Jakpus,Jakarta,Cempaka Putih,64,34,1197000000,98,Small
Dijual rumah di cluster LAGOON PARK dengan view danau di Bukit Golf Cibubur,Jakarta,Cibubur,40,60,860000000,100,Small
DP SUKA SUKA - Cluster Baru style Scandinavian STRATEGIS 700 jutaan ALL IN,Jakarta,Cijantung,68,60,770000000,128,Small
"DI JUAL RUMAH DI TAMAN ARIES, JAKARTA BARAT",Jakarta,Meruya,200,200,3900000000,400,Large
Rumah lokasi strategis butuh renovasi.,Jakarta,Kebayoran Baru,286,570,12700000000,856,Large
Rumah Dijual 2 Lantai Harga Terjangkau Daerah Lenteng Agung,Jakarta,Lenteng Agung,90,77,1800000000,167,Small
Beli Rumah Cantik FREE Yamaha N-Max 2Km dari JORR bisa KPR,Jakarta,Cipayung,124,126,2378750000,250,Medium
"jual rumah lokasi pejompongan benhil untuk di jadikan Hunian,kantor, Supermarket",Jakarta,Bendungan Hilir,300,344,18000000000,644,Large
RUMAH 2 LANTAI + ROOFTOP SIAP HUNI .BISA KPR DI JAGAKARSA JAKARTA SELATAN,Jakarta,Jagakarsa,220,124,2975000000,344,Large
Dijual Rumah Minimalis Siap Huni Di Cluster Metland Menteng Cakung Jaktim,Jakarta,Cakung,90,96,1700000000,186,Small
"(GA20308-CS) JUAL RUMAH KOS BARU OKUPANSI 100%, FAST BINTANG 5 DI TOMANG, JAKBAR",Jakarta,Tomang,264,66,4900000000,330,Large
DIJUAL RUMAH LAMA MEGA KUNINGAN Dekat Kedutaan Thailand,Jakarta,Kuningan,700,708,51000000000,1408,Large
DIJUAL RUMAH LAMA HITUNG TANAH DI DENPASAR KARANGASEM MEGA KUNINGAN,Jakarta,,500,865,55500000000,1365,Large
"GREEN LAKE, HARGA NEGO",Jakarta,,120,135,3000000000,255,Medium
Rumah Duri Kepa Hadap Barat,Jakarta,Grogol Petamburan,115,115,2000000000,230,Medium
Dijual Rumah Terawat Rapi,Jakarta,,600,800,10900000000,1400,Large
"Rumah Semi Furnish 5 Bedroom di Kebayoran Essence, Bintaro",Jakarta,Bintaro,400,322,7500000000,722,Large
Rumah Siap Pakai Lebar 10 M Di Galur Jakarta Pusat,Jakarta,Johar Baru,100,143,2450000000,243,Medium
Dijual Murah Rumah 2lantai Di Kayu Putih Jakarta Timur,Jakarta,Kayu Putih,140,116,1500000000,256,Medium
Dijual rumah tua hitung tanah di Cilandak,Jakarta,Cilandak Barat,300,676,12000000000,976,Large
"di jual kelurga harmonis, aman, nyaman, sejuk",Jakarta,Kelapa Gading,300,15,2750000000,315,Large
Rumah cantik scandinavian di jakrta selatan,Jakarta,Cijantung,100,80,1900000000,180,Medium
DI JUAL Rumah tua harga bagus didaerah Kemang. Jarak jalan kaki ke Hero.,Jakarta,Kemang,450,784,15500000000,1234,Large
DI JUAL RUMAH CANTIK SIAP HUNI DI CIPETE,Jakarta,Cipete Selatan,400,615,19500000000,1015,Large
"DIJUAL CEPAT RUMAH DI TAMAN SEMANAN INDAH, KALIDERES",Jakarta,Kalideres,200,225,3900000000,425,Large
"Murah, Jual Cepat dan BU, Kebayoran Baru Luxury House, Nego sampai Terjual",Jakarta,Kebayoran Baru,494,680,42500000000,1174,Large
Angel Residence perumahan cluster premium di Jakarta Barat,Jakarta,Kalideres,115,96,3252000000,211,Medium
Cari Rumah cluster murah cawang residence dewi sartika,Jakarta,Cawang,110,65,1750000000,175,Medium
"Dijual Rumah Cantik dan  Minimalis, 3 Lantai di Cempaka Putih Barat",Jakarta,Cempaka Putih,120,65,3500000000,185,Medium
DIJUAL RUMAH AREA SENOPATI ~ LT/LB 101/160 ~ JARANG ADA!,Jakarta,Kebayoran Baru,160,101,6000000000,261,Large
Fast Sale! Rumah Baru 4 Kamar Tidur di Menteng Jakpus,Jakarta,Menteng,500,485,45000000000,985,Large
Rumah Bagus Siap Pakai Di Jakarta Pusat,Jakarta,Senen,200,160,3900000000,360,Large
"Dijual Cepat Rumah Asri Di Lokasi Strategis  Jl. Bango Raya, Cilandak Jakarta",Jakarta,Cilandak,300,328,6500000000,628,Large
Green Puri 6x15 FULL FURNISH Lokasi Jakarta Barat,Jakarta,Duri Kosambi,100,90,2200000000,190,Medium
"cluster di Jagakarsa, Margasatwa, Pondok Labu, Cilandak, Jakarta Selatan",Jakarta,,125,152,3128000000,277,Medium
Rumah mewah 2 lantai 3 M,Jakarta,Pondok Kelapa,137,147,3000000000,284,Medium
Dijual Rumah di Sunter Lokasi Strategis Bangunan Kokoh,Jakarta,Sunter,125,140,3200000000,265,Medium
Dujual cepat rumah townhouse 3 lt di Jakarta Barat,Jakarta,Kedoya Selatan,200,70,2600000000,270,Large
Di jual rumah mewah murah fasilitas banyak di Menteng Jakarta pusat,Jakarta,Menteng,600,753,55000000000,1353,Large
ready rumah cluster daerah cempah putih tengah,Jakarta,Cempaka Putih,70,48,1725000000,118,Small
Di Jual Rumah Mewah Di Timur Jakarta DP Ringan,Jakarta,Cakung,125,150,2550000000,275,Medium
International Class Living in South City Fortunia Residence,Jakarta,Bintaro,66,71,1200000000,137,Small
HOT NEWS Millenium Cawang Residence Elegant Architecture,Jakarta,Mampang Prapatan,115,72,1700000000,187,Medium
Millenium Cawang Residence Elegant Architecture House,Jakarta,Kramat Jati,115,72,1700000000,187,Medium
Hot News DP0% BSD City Fully Furnished Tanakayu at BSD,Jakarta,Puri Indah,70,50,1400000000,120,Small
KIREI HOUSE Elegant Japanese Architecture Living at Depok,Jakarta,Jagakarsa,65,64,700000000,129,Small
Rumah Baru Depok DANDELION ESTATE- PREMIUM AREA- DP SUKA2- FREE BIAYA2,Jakarta,Ciracas,68,63,750000000,131,Small
RUMAH MEWAH  DEKAT TOL & TRANSMART CIBUBUR DP SUKA2- Free Biaya2,Jakarta,Ciracas,68,63,750000000,131,Small
MURCE CUY HARGA DIBAWAH PASARAN LOKASI EXLUSIVE BUKIT GOLF AREA PONDOK INDAH,Jakarta,Pondok Indah,2600,4689,180000000000,7289,Large
WAHH GILASEH TURUN HARGA GEDE-GEDEAAN HAMPIR SETENGAH HARGANYA RUMAH DI SENOPATI,Jakarta,Kebayoran Baru,280,485,29000000000,765,Large
Rumah Mewah Jalan Damai Jagakarsa Kebagusan - Akses 2 Mobil,Jakarta,Jagakarsa,145,84,1800000000,229,Medium
Rumah Tinggal Cantik di lebak bulus jaksel,Jakarta,Lebak Bulus,100,60,1200000000,160,Medium
Rumah baru minimalis terjangkau dan strategis di Citayam,Jakarta,Palmerah,45,55,275000000,100,Small
"Rumah Scandinavian, Cantik dan Menarik di Dalam Cluster daerah Bintaro",Jakarta,,63,94,1315000000,157,Small
"Rumah tanah luas 800m, di jl.Slamet Riyadi Matraman Jakarta timur",Jakarta,Matraman,600,800,18000000000,1400,Large
RUMAH READY SIAP HUNI DI CIBUBUR AKSES MUDAH TINGGAL NUNGGU AKAD,Jakarta,,87,68,750000000,155,Small
RUMAH MURAH MEWAH DUA SETENGAH LANTAI PULOGADUNG JAKTIM NEGO SAMPAI JADI,Jakarta,Pulo Gadung,90,40,950000000,130,Small
"DIJUAL Rumah Pribadi Asri & Nyaman, Halaman Luas, Jagakarsa, Jakarta Selatan",Jakarta,Jagakarsa,272,1150,9500000000,1422,Large
Di jual Rumah tua Menteng jakarta pusat,Jakarta,Menteng,340,238,13500000000,578,Large
Di Jual Rumah Mewah Stategis di Jakarta Barat,Jakarta,Meruya Selatan,480,450,14700000000,930,Large
Dijual Rumah Metland Puri 2 Lantai  Sudah Renovasi,Jakarta,,150,116,1700000000,266,Medium
Rumah Kos Kosan 22 Kamar Siap Huni di Komplek Rawamangun,Jakarta,Rawamangun,600,300,5700000000,900,Large
Dijual BU Rumah 2 Lantai Poltangan Pasar Minggu,Jakarta,Pejaten Timur,280,184,2600000000,464,Large
Rumah cijawura bandung kota,Bandung,Buahbatu (Margacinta),40,60,518000000,100,Small
RUMAH DIJUAL DI LEMBANG CLUSTER IBARAKI  PROMO 3 UNIT PERTAMA ,Bandung,Lembang,55,73,535000000,128,Small
Rumah modernt Asri dan Nyaman bebas banjir harga terjangkau kwalitas b,Bandung,Bandung Kulon,65,45,935000000,110,Small
Rumah Gress semi kontemporer cisaranten wetan,Bandung,Cisaranten Wetan,145,145,1600000000,290,Medium
INDUSTRIAL STYLE AREA KIARASARI RUMAH BARU,Bandung,Kiaracondong,121,80,1400000000,201,Medium
Jual rumah sayap supratman JL Cisadea,Bandung,Cibeunying Kidul,230,735,9750000000,965,Large
Dijual Cepat Rumah Kembar Timur,Bandung,,135,131,1800000000,266,Medium
1 Unit Lagi   Townhouse Ina Housing 3,Bandung,,68,87,647500000,155,Small
Renov total siap huni classic  modern di GEGERKALONG bdg utars,Bandung,Gegerkalong,189,250,2999900000,439,Large
Rumah Tumbuh banyak bukaan di Riung bandung,Bandung,Cisaranten Wetan,120,165,1690000000,285,Medium
Rumah semivilla tropis modern Dago giri bdg utara,Bandung,Dago,170,335,3500000000,505,Large
Dijual Cepat Hanya 1 Unit,Bandung,,40,64,475000000,104,Small
Hunian  Bagi Keluarga Anda di Bandung,Bandung,Cileunyi,45,105,885000000,150,Small
Rumah Dekat Kampus Unpad di Bandung,Bandung,Cileunyi,45,105,885000000,150,Small
Rumah Vila Sejuk dg Kolam dan Mataair di Pasirimpun Atas,Bandung,Pasir Impun,180,1162,1350000000,1342,Large
Rumah 1 Lantai di Lokasi Strategis  Perumahan Ekslusif Bandung Timur,Bandung,Soekarno Hatta,42,72,1001908000,114,Small
HUNIAN ISLAMI SYAHIRAH DI CIKUYA MARGAASIH CICILAN MURAH PROMO MENARIK,Bandung,Nanjung,30,60,180000000,90,Small
Sisa 1 Unit Rumah 2 Lantai Hanya 365jtan,Bandung,Parongpong,40,60,365000000,100,Small
Rumah 3 kamar tidur bisa custom tata ruang,Bandung,Cijerah,65,38,794850000,103,Small
Rumah Modern 2 Lantai Cocok Untuk Kaum Milenial di Lokasi Strategis Bandung,Bandung,Soekarno Hatta,82,90,1498040000,172,Small
Rumah Premium di Jalan Utama Perumahan Ekslusif Bandung Timur,Bandung,Rancasari,185,189,3887350000,374,Large
MURAH Turun Harga Guest House Aktif di Sanggar Hurip Soekarno Hatta,Bandung,Soekarno Hatta,300,130,1750000000,430,Large
Rumah Belanda clasik di dekat Ahmad Yani sayap Riau kota Bandung,Bandung,Riau,450,732,12800000000,1182,Large
Turun Harga Banyak  Rumah Cakep Pondok Hijau 10 Menit ke Setiabudi,Bandung,,460,300,3990000000,760,Large
Rumah Cakep Semi Furnish di Kota Baru Parahyangan  Padalarang,Bandung,,130,144,2250000000,274,Medium
Rumah Subsidi Murah di Perumahan Modern Bandung Selatan,Bandung,Banjaran,22,60,165000000,82,Small
Dijual Rumah di Jatihandap Bandung,Bandung,Cibeunying Kidul,90,98,600000000,188,Small
Rumah minimalismoderen dengan gaya klasik,Bandung,Warung muncang,70,40,847500000,110,Small
JUAL RUMAH LOKASI STRATEGIS 2 LANTAI DI KOMPLEK BUKIT INDAH PASANGGRAHAN BANDUNG,Bandung,Ujung Berung,148,91,500000000,239,Medium
Mandala town house bandung jual rumah siap huni,Bandung,Warung muncang,65,38,794850000,103,Small
Rumah Baru di Duta Graha ResidenceBanyu Biru Pasir Pogor,Bandung,,40,72,550000000,112,Small
Rumah dijual cepat lokasi di CLUSTER Garden Villas Pinus Regency,Bandung,,85,72,850000000,157,Small
5 MENIT TOL SEROJA Soreang Bandung,Bandung,Soreang,36,73,667407000,109,Small
jual rumah murah 2 lantai dekat tol pasir koja bandung kota,Bandung,Andir,58,35,750000000,93,Small
200 meter Jlah nasution cicahem bandung BISA KPR,Bandung,Cicaheum,62,62,1042570029,124,Small
Grand Sharon Hunian Istimewa Konsep Baru Pencahayaan Alami Di Bandung Timur,Bandung,Gedebage,42,72,866300000,114,Small
Rumah murah di Banding kota,Bandung,Bandung Kulon,70,40,847500000,110,Small
Jual rumah bandung barat,Bandung,Padalarang,75,84,802000000,159,Small
Rumah 2 lantai BATUNUNGGAL bisa untuk kost2an atau kantor,Bandung,Batununggal,340,220,4300000000,560,Large
RUMAH SIAP HUNI HANYA SATU UNIT DI KAWASAN PODOMORO PARK BANDUNG,Bandung,Bojongsoang,94,90,1700000000,184,Medium
Rumah Subsidi Modern Terbaik di Arjasari Bandung Selatan,Bandung,Buahbatu,30,60,150500000,90,Small
Rumah baru semi villa view gunung dan kota bandung,Bandung,Cileunyi,50,63,428888889,113,Small
Rumah Subsidi Soreang,Bandung,Soreang,30,60,155500000,90,Small
rumah murah tengah kota bandung cluster ciwastra urban living grand sumarecon,Bandung,Ciwastra,70,74,650000000,144,Small
rumah harga promo ready stock arcamanik,Bandung,Arcamanik,36,136,899000000,172,Small
Ashfara permata sukamukti,Bandung,Katapang,30,60,278092000,90,Small
Jual Cepat Murah Rumah  Kost Jl Sukabumi dkt Mall IBCC,Bandung,Batununggal,180,96,825000000,276,Large
Jual Rumah Jl Kembar Bandung Nego Sampai Deal,Bandung,Regol,120,246,1800000000,366,Medium
RUMAH SUBSIDI GRAND RISCON SOREANG DEKAT TOL SOROJA,Bandung,Soreang,30,60,150500000,90,Small
Rumah Asri dan Nyaman di Arcamanik,Bandung,Arcamanik,260,280,3500000000,540,Large
Dijual rumah murah minimalis taman cibaduyut indah tci,Bandung,Cibaduyut,65,80,820000000,145,Small
RUMAH SUBSIDI KOTA BARU ARJASARI BANDUNG SELATAN,Bandung,Banjaran,30,60,155025000,90,Small
Rumah Minimalis di Cluster Favorite Taman Kopo Indah 5,Bandung,Margahayu,115,118,1450000000,233,Medium
padasuka rumah murah jatihandap asri ahmad land cicaheum dkt arcamanik antapani,Bandung,Jatihandap,36,84,365000000,120,Small
Rumah murah di sariwangi asri,Bandung,Sarijadi,90,99,1350000000,189,Small
Rumah Baru Downslope di Bandung padalarang jayamekar kota baru parahyangan,Bandung,Padalarang,36,60,500830800,96,Small
Jarang ada Rumah Baru Siap Huni di Gedebage Kota Bandung dekat Pintu Tol,Bandung,Gedebage,50,73,650000000,123,Small
Rumah murah di Bandung selatan,Bandung,Soreang,30,60,283000000,90,Small
Rumah Citra Green DAGO,Bandung,Dago,520,440,11800000000,960,Large
RUMAH SUBSIDI BANJARAN BANDUNG PROMO HANYA 75JUTA BIAYANYA,Bandung,Banjaran,30,61,150500000,91,Small
Rumah Baru 2 lantai Arcamanik Bandung Timur Cisaranten Kulon dekat antapani,Bandung,Arcamanik,125,119,1699750000,244,Medium
Dijual Rumah Baru Modern dekat Tol Pasteur Bandung Utara Cashback Edisi Lebaran,Bandung,Pasteur,149,63,1499000000,212,Medium
2 LANTAI 600JTAN RIUNG GALERI KOTA BANDUNG,Bandung,,45,101,675000000,146,Small
Rumah Murah Dibawah Harga Pasaran Turangga Buahbatu,Bandung,Turangga,150,300,2350000000,450,Medium
perumahan di lokasi strategis harga terjangkau fullspek  free desain,Bandung,Pameungpeuk,40,60,170000000,100,Small
rumah mewah ready stock indent villa bukit cileunyi bkkbn cimekar bandung,Bandung,Cileunyi,40,63,385000000,103,Small
Rumah Kompleks Mekarwangi,Bandung,Mekarwangi,200,300,3800000000,500,Large
hunian minimalis di kab bandung harga terjangkau lokasi strategis,Bandung,Pameungpeuk,40,60,175000000,100,Small
jual rumah komplek mekarwangi,Bandung,Mekarwangi,360,180,4850000000,540,Large
WHITE HOUSE CIBIRU  CLUSTER MILENIAL TANPA BI CHECKING  BEBAS RIBA DAN DENDA,Bandung,Cileunyi,38,60,373000000,98,Small
Dijual Kosan Aktif di Lokasi Strategis di Turangga Buahbatu Kota Bandung,Bandung,Buahbatu,530,200,4000000000,730,Large
Jual Rumah Minimalis Komplek Permata biru Cinunuk,Bandung,Cileunyi,40,60,340000000,100,Small
Rumah Minimalis Industrial Semi Vila di Citra Green Dago Fully Furnished,Bandung,Dago,200,200,2750000000,400,Large
The Emeralda Resort Rumah Impian Masa Kini,Bandung,Padalarang,60,60,589000000,120,Small
Hanya 900 Jutaan Bisa Dapat Rumah Type Upslope,Bandung,Padalarang,75,84,900000000,159,Small
Rumah siap huni bergaransi grand duta rancatungku bandung,Bandung,,30,60,184000000,90,Small
Perumahan Baru Nuansa Villa di Arcamanik Kotamadya Bandung One Gate,Bandung,Antapani,77,119,1276000000,196,Small
Dp 0 cicilan 900000 an arjasari banjaran,Bandung,Arjasari,30,60,155025000,90,Small
Rumah Industrial Style dekat Kampus Jatinangor,Bandung,Cileunyi,36,60,425000000,96,Small
Rumah cantik menarik di Villa Pasirwangi Ujungberung Kota Bandung,Bandung,Ujung Berung,45,125,635000000,170,Small
Rumah Minimalis Harga Terjangkau dekat Exit Tol Cileunyi,Bandung,Cileunyi Kulon,30,60,395000000,90,Small
Jual cepat rumah siap hunistrategis sarijadi,Bandung,Sarijadi,647,306,9700000000,953,Large
DIJUAL CEPAT RUMAH MURAH READYSTOCK MINIMALISBANDUNG TIMUR CIBIRU,Bandung,Cibiru,40,60,337000000,100,Small
Rumah Sayap Cipanganti Bawah Rumah Pusat Kota Bonus 14 Kamar Kost,Bandung,Cipaganti,300,830,21500000000,1130,Large
Cluster Rumah Mewah Vigentta Soreang,Bandung,Soreang,60,70,689000000,130,Small
Rumah subsidi DP 0,Bandung,Arjasari,30,60,155025000,90,Small
Rumah Milenial 2Lt View Cantik Udara Sejuk Segar di Cipadung Kotamadya Bandung,Bandung,Arcamanik,41,50,453000000,91,Small
Rumah Dekat Borma Katapang Dp 30 Jt All In Angsuran 21 Jt SHM,Bandung,Katapang,36,60,433300000,96,Small
Rumah Siap Huni,Bandung,,120,153,1350000000,273,Medium
RUMAH MURAH BEBAS BANJIR DI KOTA BANDUNG  BENTANG ARTHA RESIDENCE,Bandung,Buahbatu,46,95,620000000,141,Small
Dijual rumah unik dan minimalis semi furnish di Taman Kopo Indah 5,Bandung,Kopo,240,280,3000000000,520,Large
Dijual Rumah Minimalis Modern Di Tengah Kota Sayap Turangga,Bandung,Turangga,350,308,5499000000,658,Large
RUMAH TERBAIK PADALARANG Jaminan Legalitas AMAN Blok E Residence,Bandung,Padalarang,45,69,603635800,114,Small
Rumah Suryalaya Baru Bandung,Bandung,Buahbatu,350,386,4200000000,736,Large
Di Jual Rumah Malabar,Bandung,Batununggal,400,805,13000000000,1205,Large
Dijual Rumah di Jl Dr Setiabudi  Bandung,Bandung,Cidadap,400,620,18000000000,1020,Large
Rumah Bandung Utara dekat Universitas Maranatha daerah Sariwangi Sarijadi,Bandung,Parongpong,80,102,1317654800,182,Small
Rumah Large Cipaganti Dekat PVJ Kamar Tidur 8,Bandung,Cipaganti,750,568,19500000000,1318,Large
Rumah murah bandung,Bandung,Katapang,50,70,265000000,120,Small
Rumah Baru Dp Ringan 25jt all In sd terima kunci cicilan 26jtbln,Bandung,Cileunyi,36,85,479000000,121,Small
Rumah Terawat Jalan Dahlia Sayap Riau Murah,Bandung,,250,200,6100000000,450,Large
Prima amerta rumah baru dp5jt lokasi dekat tol soroja kota soreang bandung,Bandung,Soreang,40,72,495000000,112,Small
Dijual Rumah Asri Etnik Nusantara Di Pasirsalam,Bandung,Pasirluyu,236,360,4600000000,596,Large
Dijual Rumah Type Tipikal Di Batununggal,Bandung,Batununggal,240,198,3250000000,438,Large
Bumi Pratama Asri Cluster Exclusive Bandung Timur 100 Meter dari Jalan Nasional,Bandung,Cinunuk,40,60,479750000,100,Small
Rumah cluster one gate keamanan 24 jam promo,Bandung,Cinunuk,36,60,255000000,96,Small
Dijual RUMAH di PODOMORO PARK BANDUNG Cluster Premium Brahmapuri,Bandung,Buahbatu,147,140,3800150000,287,Medium
hunian minimalis modern di kab bandung harga terjangkau,Bandung,Pameungpeuk,50,70,211000000,120,Small
Jual Rumah Kost di Cisitu Lama Dago Dekat Kampus ITB,Bandung,Dago,700,500,8975000000,1200,Large
Rumah Situsari Akses Jalan Lebar Ada Kosan,Bandung,Lengkong,187,198,2600000000,385,Large
Rumah Mewah Strategis 2Lt di Arcamanik Kotamadya Bandung,Bandung,Antapani,125,119,1750000000,244,Medium
Dijual Rumah Setrasari Tengah,Bandung,,220,130,3119000000,350,Large
Murah rumah 3 lantai hrg 420jt nego di panyileukan kodya Bandung,Bandung,Soekarno Hatta,111,60,420000000,171,Medium
Rumah Luas Nyaman Dan Asri Dengan Adanya Taman Hijau,Bandung,,500,375,10200000000,875,Large
Rumah Strategis Sukaluyu Terawat,Bandung,Cikutra,300,396,5400000000,696,Large
rumah luas harga murah lt270150 hrg1850jt di arcamanik endah bandung,Bandung,Arcamanik,155,270,1850000000,425,Large
Rumah Mewah Minimalis Kawasan Utara Bandung Timur View Pegunungan dekat Exit Tol,Bandung,Cibiru,36,72,456000000,108,Small
Graha Panyileukan,Bandung,Panyileukan,68,60,772000000,128,Small
Rumah 2 Lantai 10KT 5KM Semi Furnished Di Cijaurah Soekarno Hatta Bandung,Bandung,Soekarno Hatta,900,587,8500000000,1487,Large
Di Jual Rumah  Podomoro,Bandung,,127,126,2750000000,253,Medium
Rumah siap Huni di Sariwangi,Bandung,Sarijadi,90,122,1150000000,212,Small
JUAL RUMAH PERMATA BIRU BARU RENOVASI,Bandung,Cileunyi,45,60,360000000,105,Small
Dijual Rumah Minimalis Modern di Pusat kota Bandung,Bandung,Garuda,74,48,1086000000,122,Small
Rumah Lux di cluster Elite Singgasana Haven ex Golf,Bandung,Mekarwangi,240,160,4500000000,400,Large
Jual Villa Murah Bandung,Bandung,Lembang,128,1500,1800000000,1628,Medium
Rumah Rasa 2 Lantai Murah Fasilitas Kota Baru Parahyangan,Bandung,Bandung Kulon,36,72,457000000,108,Small
WHITE HOUSE CIBIRU,Bandung,Cibiru Hilir,38,60,373000000,98,Small
legalitas dijamin aman perumahan grand duta rancatungku,Bandung,,45,72,338000000,117,Small
Cluster ter MURAAH Arcamanik kota bandung strategis dekat Polsek Arcamanik,Bandung,Arcamanik,36,60,525000000,96,Small
rumah siap huni paling laris murah masuk mobil,Bandung,Buahbatu,30,45,115000000,75,Small
jual cepat rumah siap huni istana mekar wangi,Bandung,Mekarwangi,165,245,3750000000,410,Large
kavling di lokasi strategis di kab bandung harga terjangkau fullspek,Bandung,Pameungpeuk,36,50,151000000,86,Small
Podomoro Park Bandung Cluster Fashagriya,Bandung,Buahbatu,94,90,1440000000,184,Medium
Podomoro Park Bandung Cluster Padmagriya,Bandung,Buahbatu,36,66,850000000,102,Small
rumah Bandung timur,Bandung,Ujung Berung,45,72,550000000,117,Small
Jual Rumah Dekat Tol Pasteur Dibawah 1M Jarang Ada,Bandung,Cicendo,60,90,800000000,150,Small
Rumah 3 KT  2 KM dekat ke Jalan Nasional di Bandung Timur,Bandung,Cileunyi Kulon,54,60,627000000,114,Small
JUAL RUMAH PADASUKA KOMPLEK USB YPKP CIMEUNYAN,Bandung,Cimenyan,50,72,635000000,122,Small
Dijual  Rumah Gunung Batu Bandung Harga Nego,Bandung,,240,270,2500000000,510,Large
DIJUAL RUMAH MINIMALIS KONSEP CLASIC  BENTANG ARTHA BANDUNG,Bandung,Buahbatu,41,78,543111000,119,Small
WOW GRATIS SHM CUMA DI BANDUNG SELATAN DIJUAL MURAH RUMAH VILLA,Bandung,Soreang,40,83,345000000,123,Small
Dijual Rumah 5 Kamar Tidur di Bandung,Bandung,Buahbatu,125,90,850000000,215,Medium
Rumah di Surapati Core,Bandung,Cibeunying Kidul,110,193,2500000000,303,Medium
Dijual Rumah 5 Kamar Tidur di Bandung,Bandung,Buahbatu,125,90,850000000,215,Medium
LAUNCHING RUMAH BARU HARGA 800 JUTAAN DI KAWASAN DAGO RESORT,Bandung,Cimenyan,50,86,810000000,136,Small
Rumah Dijual Harga Spesial Awal Bulan Hemat 300 jtan,Bandung,Padalarang,75,84,600000000,159,Small
Jual rumah baru daerah Bandung Padalarang dekat ikea kota baru parahyangan,Bandung,Padalarang,36,72,443747700,108,Small
Rumah Bandung Timur di Ciwastra Gedebage Buahbatu Margacinta Bojongsoang murah,Bandung,Bojongsoang,36,91,805983300,127,Small
Podomoro Park Bandung Cluster Brahmapuri,Bandung,Buahbatu,147,140,3490000000,287,Medium
Rumah Baru di Bandung Soreang Panyirapan Sukanagara Cempaka Ciwidey Kopo,Bandung,Soreang,36,106,569921800,142,Small
Jual Villa Bandung full furnished view keren,Bandung,Dago,128,1500,1800000000,1628,Medium
RUMAH DEKAT TOL PADALARANG BIKIN HATI TENANG cuma 2 menit kurang,Bandung,Padalarang,55,62,766900125,117,Small
Podomoro Park Bandung Cluster Anapuri,Bandung,Buahbatu,156,160,3266500000,316,Large
Dijual Rumah Large Dipusat Kota Bandung,Bandung,Batununggal,400,336,4200000000,736,Large
DI AREA HIJAU ADA SI CANTIK YANG BIKIN JATUH HATI RUMAH DAGO PAKARBDG,Bandung,Dago,215,314,3000000000,529,Large
Rumah Murah Hitung Tanah Blakang Horison Dkt SMA 5 Turangga Buahbatu,Bandung,Turangga,105,180,1599000000,285,Medium
PROMO AWAL TAHUNRumah Type downslope 25 Lantai di padalarang,Bandung,Padalarang,75,84,500000000,159,Small
Dijual Rumah Sukahaji Permai,Bandung,,300,238,3650000000,538,Large
Rumah Minimalis dekat Jalan Tol Cileunyi,Bandung,Cileunyi,36,69,434000000,105,Small
Rumah 25 lantai padalarang promo 700 jutaan 10 menit ke exit tol padalarang,Bandung,Padalarang,75,84,754000000,159,Small
Rumah Mewah Resor Dago Pakar,Bandung,Coblong,850,428,13000000000,1278,Large
HOT BERANI TURUN JAUH LANGSUNG NEGO AJA RUMAH BAGUS JARANG ADA DI PARONGPONG,Bandung,Parongpong,560,835,7000000000,1395,Large
Rumah DP ringan dekat gerbang toll simpang susun cileunyi,Bandung,Cileunyi Kulon,36,72,435000000,108,Small
Dijual rumah tinggal perumahan Pondok Hijau,Bandung,,240,220,3750000000,460,Large
BUTIK SARIWANGI 2 LANTAI SIAP HUNI MULAIDARI 600JTAN NEGO,Bandung,Mekarwangi,55,74,650000000,129,Small
Dijual Rumah Batununggal Dlm Cluster,Bandung,Batununggal,170,210,3000000000,380,Large
Rumah Cantik 2 Lantai Idaman Dengan skema cicilan 36 Kali Pembayaran Tanpa bank,Bandung,Cibiru Hilir,45,85,531250000,130,Small
Rumah di Coblong nego,Bandung,Coblong,250,248,4500000000,498,Large
PALING MURAH RUMAH 2 LANTAI 400JTAN STRATEGIS CIBIRU,Bandung,Cibiru,50,72,495000000,122,Small
DiJual Rumah di JlWindu Akses JlGatot Subroto  Pelajar Pejuang Harga 87 M,Bandung,Lengkong,350,410,8800000000,760,Large
rumah murah bandung timur,Bandung,Cibiru Wetan,80,60,335000000,140,Small
DIJUAL CEPAT Rumah di Soreang Indah,Bandung,Soreang,120,66,750000000,186,Medium
RUMAH BARU DI MARGAHAYU RAYA AKSES STRATEGIS JALAN LEBAR DEKAT METRO INDAH MALL,Bandung,Margahayu,120,120,1200000000,240,Medium
Sisa 1 Unit Rumah baru 2 lantai area Pasir Salam Kembar Bkr Buah batu,Bandung,Buahbatu,150,110,1900000000,260,Medium
HARGA NEGO RUMAH BARU 2 LANTAI DI TURANGGA BUAH BATU STRATEGIS TENGAH KOTA,Bandung,Turangga,160,126,2300000000,286,Large
Di JualRumah Dua Lantai Murah Inden Arjuna Land City,Bandung,Bojongsoang,45,60,460000000,105,Small
Rumah Minimalis Arjuna Land City Bojongsoang,Bandung,Buahbatu,36,50,287000000,86,Small
MURAH Rumah Lama Daerah Taman Holis Indah Jual Cepat,Bandung,Cigondewah,108,96,1200000000,204,Medium
rumah semi villa dgn kolam ikan di cisarua,Bandung,Cisarua,100,280,882000000,380,Medium
Rumah 2 Lantai Komplek Bandung Timur Regency,Bandung,Ujung Berung,140,120,1600000000,260,Medium
Dijual Rumah Baru Lux Modern di Komplek Elite Setiabudi Regency Bandung Utara,Bandung,Setiabudi,1100,1000,29000000000,2100,Large
Rumah Minimalis Ready Stok Murah Bandung,Bandung,Pameungpeuk,45,72,200000000,117,Small
rumah fullspek dekat tol soroja sudah shm,Bandung,Soreang,36,50,155000000,86,Small
Rumah murah mewah jln elang Maleber Andir Bandung kota,Bandung,Andir,74,56,1000000000,130,Small
Rumah murah mewah cibuntuBandung kulon,Bandung,Bandung Kulon,70,40,800000000,110,Small
Dijual Rumah 2 Lantai Cisaranten Kidul Etnik Bali DP 0 Lokasi Pinggir Jalan Uta,Bandung,Gedebage,83,91,1200000000,174,Small
Rumah Minimalis Mewah Tapi Murah Siap huni Bandung,Bandung,Rancamulya,40,60,230000000,100,Small
DIJUAL Rumah Baru Minimalis Dalam Pembangunan di Griya Caringin Jatinangor Jln,Bandung,Jatinangor,50,60,525000000,110,Small
RUMAH SIAP HUNI DI GAHARU RESIDENT,Bandung,Katapang,40,60,240000000,100,Small
rumah bagus jl saturnus utara margahayu raya,Bandung,Rancasari,196,204,2500000000,400,Large
Dijual Rumah sangat terawat SIAP HUNI di Kopo Bandung 65M NEGO,Bandung,Margahayu,1000,1000,6500000000,2000,Large
Podomoro Park Bandung Cluster Wangsagriya,Bandung,Buahbatu,82,72,1470000000,154,Small
rumah nyaman dekat tol soroja harga terjangkau,Bandung,Soreang,36,50,155000000,86,Small
rumah mewah  peninggalan belanda,Bandung,Cicendo,374,1268,39900000000,1642,Large
RUMAH ASRI DI BURANGRANG PUSAT KOTA BANDUNG DEKAT KE ASIA AFRIKA,Bandung,Buahbatu,250,301,3950000000,551,Large
Rumah 2 lantai dengan 51 kelebihan di Bandung Selatan,Bandung,,65,72,1126000000,137,Small
Jarang ada 600jutaan  sangat dekat ke Antapani Kota Bandung,Bandung,Antapani,45,75,650000000,120,Small
Dijual rumah 2 lt dlm cluster elite mekarwangi,Bandung,Mekarwangi,110,75,1650000000,185,Medium
Rumah Komersil 2 kamar DP 1 jt Bisa Allinn Sampai Akad dan Terima Kunci,Bandung,Cicalengka,30,66,419000000,96,Small
Rumah Milyuner di  Kota Mandiri,Bandung,Gedebage,90,73,1600000000,163,Small
perumahan mewah islami di padasuka dekat terminal cicaheum dan bandung kota,Bandung,Padasuka,120,110,1370000000,230,Medium
PROMO GILA  DIJUAL RUMAH 2 LANTAI HARGA MIRING DI BANDUNG,Bandung,Soreang,40,83,376000000,123,Small
Rumah tanpa Dp kekinian,Bandung,Banjaran,40,72,312000000,112,Small
rumah nyaman,Bandung,,120,250,890000000,370,Medium
Rumah Resor Dago Pakar Harga Nego,Bandung,Coblong,300,354,5000000000,654,Large
Cukup DP 1 Jt  Bisa Dapat Rumah Cantik Murah Dengan Pemandangan Kota Cicalengka,Bandung,Cileunyi Kulon,30,66,340000000,96,Small
RUMAH SIAP HUNI BUTIK SARIWANGI ALA AMERIKA KLASIK 600JTAN,Bandung,,65,74,820000000,139,Small
Rumah Terawat Golf Barat Arcamanik,Bandung,Arcamanik,466,300,3200000000,766,Large
Dijual rumah 2 lt on progress di batununggal indah,Bandung,Batununggal,110,84,1800000000,194,Medium
CUSS JANGAN SAMPAI KELEWATAN HUNIAN MINIMALIS DI ARCAMANIK BIKIN BETAH BANGET,Bandung,Arcamanik,102,98,840000000,200,Medium
Rumah vintage Bandung dekat pusat kota,Bandung,Arcamanik,36,137,1170000000,173,Small
Rumah daerah sekelimus Buah Batu Bandung belakang spbu buah batu,Bandung,Buahbatu,130,90,800000000,220,Medium
Cihanjuang villas,Bandung,Parongpong,45,100,500000000,145,Small
Rumah 200 jutaan DEKAT PODOMORO PARK Buah Batu Bandung Harga Termurah di bawah,Bandung,Bojongsoang,32,50,280000000,82,Small
Rumah Siap Huni View Kota Bandung Di Buana Hiltop Bandung,Bandung,Cilengkrang,112,148,699000000,260,Medium
Type Hook Summer Hills Dago,Bandung,Dago,55,102,749000000,157,Small
CIWARUGA VILLAS,Bandung,Parongpong,40,90,500000000,130,Small
Rumah terawat Dago mainroad,Bandung,Coblong,112,2822,126990000000,2934,Medium
Hadiahkan untuk keluarga tercinta anda,Bandung,Parongpong,40,120,535000000,160,Small
Rumah Islami di Soreang Bandung Selatan Green Soreang Residence,Bandung,Soreang,36,75,467000000,111,Small
Rumah Murah Mega Raya Pasteur,Bandung,Arcamanik,160,160,1600000000,320,Large
Dijual rumah sangat strategis sayap dago,Bandung,Coblong,680,650,18500000000,1330,Large
klaster Terbaru Podomoro Park,Bandung,Bojongsoang,82,72,1688000000,154,Small
RUMAH BENTANG ARTHA RESIDENCE TAHAP 3 BATCH 2,Bandung,Buahbatu,45,61,450600000,106,Small
Dijual Rumah Daerah Pasir Jati,Bandung,Pasir Jati,160,107,925000000,267,Large
Rumah Bagus Minimalis Siap Huni di Komplek Margaasih dekat ke Gerbang Tol Margaasih,Bandung,Margaasih,90,103,550000000,193,Small
RUMAH CLUSTER MUTIARA DREAMLAND ARCAMANIK,Bandung,Arcamanik,60,90,700000000,150,Small
Rumah Neglasari,Bandung,Ciumbuleuit,155,1164,17460000000,1319,Large
Rumah Kekinian dekat Toll Cileunyi Bandung Timur,Bandung,Cileunyi,36,72,480000000,108,Small
DIJUAL RUMAH SIAP HUNI DI DAGO KOTA BANDUNG,Bandung,Dago,150,200,3000000000,350,Medium
Batununggal  Dijual Rumah Murah Batununggal,Bandung,Batununggal,200,250,3000000000,450,Large
dijual cepat rumah siap huni di bumi orange,Bandung,Cibiru,36,60,195000000,96,Small
Dijual Rumah Summer Hills Dago Living Premium,Bandung,Dago,150,200,2900000000,350,Medium
Rumah mewah Lembang Bandung,Bandung,Lembang,350,276,4075000000,626,Large
Rumah 2 KT di Kawasan Bebas Banjir dan Sejuk dekat Tol Cileunyi,Bandung,Cileunyi Kulon,36,60,425000000,96,Small
PALING MURAH RUMAH 1 LANTAI 300JTAN PALING VIRAL CIBIRU,Bandung,Sukajadi,36,72,395000000,108,Small
Dijual rumah lux di sayap pungkur lengkong,Bandung,Lengkong,400,235,5000000000,635,Large
Rumah Large bangunan lama dalam komplek Cibeureum kodya bandung,Bandung,Cijerah,500,743,4500000000,1243,Large
jual cepat rumah siap huni sayap hegarmanah,Bandung,Hegarmanah,370,293,4150000000,663,Large
600jutaan rumah di Kamayangan Residence harga NEGO ,Bandung,Arcamanik,40,75,670000000,115,Small
Jual Rumah Baru Mewah Minimalis Sumber Sari Bandung,Bandung,Soekarno Hatta,240,180,3750000000,420,Large
Rumah Bagus Siap Huni Arcamanik Bandung,Bandung,Arcamanik,280,330,2300000000,610,Large
Rumah  Kavling Laris Ciwaruga Joro Dekat  Wisata Lembang Sisa 1 Unit Lagi,Bandung,Parongpong,45,125,535000000,170,Small
Rumah murah idaman di GPAC2 Blok Chiisana Sakura Cileunyi Bandung,Bandung,Cileunyi,36,72,372000000,108,Small
Dijual Rumah di Cigadung Selatann III  Bandung,Bandung,Cibeunying Kaler,315,315,4500000000,630,Large
Siap Huni Rumah Pasir Salam,Bandung,Regol,110,74,1400000000,184,Medium
Milenial Wajib Punya Rumah Ini Gaya Jepang di Pasirjati Ujungberung,Bandung,Cilengkrang,61,72,671000000,133,Small
Dijual rumah mewah suasana sejuk,Bandung,Hegarmanah,700,1302,24200000000,2002,Large
rumah murah lokasi dekat pusat kota bandung,Bandung,Pameungpeuk,36,56,154000000,92,Small
KAWASAN PREMIUM BANDUNG DEKAT KOTABARU THE EMERALDA RESORT BANDUNG PAD,Bandung,Padalarang,75,84,750000000,159,Small
Rumah strategis pusat kota bandung,Bandung,Soekarno Hatta,167,172,1049000000,339,Large
Rumah gagah di Cisaranten ancarmanik,Bandung,Cisaranten Kulon,50,75,645000000,125,Small
SURVEY RUMAH BERKELAS DI SETRADUTABANDUNG PASTI IDOLA KELUARGA,Bandung,Sukasari,700,700,16500000000,1400,Large
KELAMAAN MIKIR PASTI KEHABISAN RUMAH ELIT DI SETRADUTABANDUNG BURUAN,Bandung,Sukasari,226,205,3700000000,431,Large
BIKIN KEJUTAN KELUARGA YUK MILIKI RUMAH IMPIANYA DI SETRADUTABANDUNG,Bandung,Sukasari,500,529,11500000000,1029,Large
Rumah gagah di Cisaranten ancarmanik,Bandung,Cisaranten Kulon,50,75,645000000,125,Small
Rumah Hook Terawat di Setra Duta Cemara Bandung,Bandung,,180,114,2678000000,294,Large
Jual Ngebut   Rumah Asri Luas di Sayap Dago Tubagus Ismail Bandung,Bandung,Dago,400,450,6500000000,850,Large
HEY KAMU  IYA KAMU  INI LHO RUMAH YANG DICARICARI DI BUAH BATU,Bandung,Buahbatu,120,160,1675000000,280,Medium
Rumah Bagus Terawat di Setra Duta Bandung,Bandung,,180,222,6000000000,402,Large
Rumah Minimalis Strategis di Istana Regency Sayap Pasteur Bandung,Bandung,Pasteur,163,120,3100000000,283,Large
Rumah Asri Hitung Tanah Saja Di Dekat Kampus NHI Setiabudi Bandung,Bandung,Setiabudi,225,314,2900000000,539,Large
Turun Harga  Dijual Cepat Rumah 2Man di Kopo Permai Bandung,Bandung,Kopo,237,234,2950000000,471,Large
SINI YUK CEK RUMAH ELIT DI BATUNUNGGALBANDUNG BISA JADI BEST DEAL LHO,Bandung,Batununggal,400,450,8500000000,850,Large
New Sale Rumah di Cluster Flora Tipe Freya Standar Upgrade,Bandung,Gedebage,98,105,1600000000,203,Medium
Dijual Cepat Rumah Dalam Cluster Ciwastra Siap Huni,Bandung,Rancasari,120,170,980000000,290,Medium
KEREN GINI LHO RUMAHNYA PASTI ADA DI TAMAN MILENIUMPASTEURBANDUNG,Bandung,Pasteur,450,213,6300000000,663,Large
Dijual rumah minimalis 2 lantai di cihanjuang bandung barat dekat lembang,Bandung,Parongpong,45,105,300000000,150,Small
Rumah town house ditengah kota dijual,Bandung,Cibeunying Kidul,220,157,2400000000,377,Large
RUMAH MURAH DI KOTA BANDUNG  BENTANG ARTHA HUNIAN TERBAIK,Bandung,Buahbatu,46,72,518004000,118,Small
rumah murah bandung selatan tanpa Dp,Bandung,,40,72,312000000,112,Small
Rumah nego Lokasi jalan raya Setiabudi dekat terminal ledeng UPI,Bandung,Ledeng,230,235,3500000000,465,Large
PROMO TERBARU CLUSTER JANET PARK2 500 JUTAAN,Bandung,Bandung Kulon,60,60,589000000,120,Small
Rumah promo cileunyi terbatas cluster one gate system,Bandung,Cileunyi,30,60,195000000,90,Small
Rumah 2lt di Soreang Bandung lt 83 lebar muka 7 SHM IMB hanya 399jtan,Bandung,Soreang,40,83,399000000,123,Small
Dapatkan dengan harga terjangkau,Bandung,Padalarang,75,84,600000000,159,Small
Hunian Asri Bandung Timur Beneevill Village,Bandung,Cikadut,40,60,440000000,100,Small
RUMAH READYSTOCK MURAH CIBIRU DEKAT UIN,Bandung,Cibiru,40,60,345000000,100,Small
Rumah Bandung Utara dijual,Bandung,Dago,170,427,5000000000,597,Large
Rumah Murah minimalis di Cibiru Village,Bandung,Cileunyi,40,60,357000000,100,Small
RUMAH PALING LARIS DI BUAH BATU,Bandung,Bojongsoang,38,77,405000000,115,Small
Rumah Sarijadi hanya 10 menitan dari tol Pasteur,Bandung,Pasteur,190,144,2950000000,334,Large
Rumah Minimalis Lokasi Strategis dekat Exit Tol Cileunyi,Bandung,Cileunyi,30,66,335000000,96,Small
Rumah gaya klasik yg masih kokoh di mainroad kota Bandung jabar,Bandung,Sumur Bandung,269,458,9000000000,727,Large
Dp murah view indah kualitas mewah,Bandung,Cicalengka,50,72,566500000,122,Small
Rumah Cantik View Kota Bandung di Jatihandap,Bandung,Jatihandap,50,98,496000000,148,Small
Dijual cepat rumah murah di sebelah Summarecon Bandung Gedebage,Bandung,Gedebage,50,60,325000000,110,Small
Rumah Mewah 2 Lantai Murah  Rooftop [ Bumi Sariwangi 1],Bandung,Setiabudi,90,96,1200000000,186,Small
Rumah Minimalis 2 Lantai di Grand Sharon Bandung,Bandung,Rancasari,82,82,999000000,164,Small
Rumah Megah Australian Style Ada Taman di Sayap Dago Kota Bandung,Bandung,Dago,1000,2000,45000000000,3000,Large
Rumah Minimalis TKI 1,Bandung,Kopo,36,84,775000000,120,Small
Rumah Griya Pratama Asri Cileunyi Super Blok Sakura Bandung Dekat Akses Tol,Bandung,Cileunyi,36,60,420000000,96,Small
Rumah arcamanik green caraka residence dekat rsal islam nyaman nyaman bandung,Bandung,Arcamanik,80,60,1400000000,140,Small
RUMAH MURAH DI KAWASAN KOTA BARU PADALARANG 5 MENIT DARI IKEA,Bandung,Andir,75,84,700000000,159,Small
Rumah Pasteur utk kontrakan,Bandung,Sukajadi,100,44,450000000,144,Medium
Rumah Lama di Setiabudi Bandung,Bandung,Setiabudi,225,730,7000000000,955,Large
dijual rumah terawt 2 lantai di rancaekek kencana,Bandung,Rancaekek,144,244,1550000000,388,Medium
tanah rumah dijual murah di ciparay,Bandung,Ciparay,635,1035,8500000000,1670,Large
DiJual Rumah Murah Di Bandung Timur Dengan Suasana Asri Pesawahan,Bandung,Cibiru Wetan,40,60,357000000,100,Small
Rumah Megah Siap Huni Di Kawasan Wisata Lembang Lingkungan Aman Cluster Islami,Bandung,Lembang,350,276,4074999000,626,Large
Rumah Komplek Antapani mas Area Antapani,Bandung,Antapani,90,182,1350000000,272,Small
Rumah mewah dan nyaman,Bandung,Arcamanik,125,138,2000000000,263,Medium
DI JUAL RUMAH MURAH DI BANDUNG300jutaan,Bandung,Bojongsoang,36,60,290000000,96,Small
Promo Rumah 200 Juta an 15 menit dari tol buah,Bandung,Bandung Kidul,30,50,225000000,80,Small
Rumah Panyileukan yang keren dan terjangkau,Bandung,Panyileukan,55,65,585000000,120,Small
jual cepat rumah lux siap huni sayap dago,Bandung,Dago,450,650,8500000000,1100,Large
Rumah nego cigadung bandung,Bandung,Cibeunying Kaler,355,210,4000000000,565,Large
Rumah Nyaman Sejuk Dekat Wisata Lembang Free SHM Dan Sisa 1 Unit Terak,Bandung,Padalarang,45,125,545000000,170,Small
Rumah Murah 2 Lantai di Setra Duta Cemara Bandung Utara,Bandung,,240,140,2400000000,380,Large
dijual cepat rumah nyaman di bandung,Bandung,,100,161,600000000,261,Medium
Rumah Mewah Lux Ada Kolam Renang di Sayap Dago Bandung,Bandung,Dago,1000,1041,55000000000,2041,Large
KAWASAN HIJAU BIKIN KELUARGA SEHAT RUMAH DI RESORT DAGO PAKARBANDUNG,Bandung,Dago,220,179,2000000000,399,Large
Rumah Kosan Aktif Lokasi Stategis Perumahan Cluster,Bandung,,240,120,1700000000,360,Large
rumah di antapani dekat pusat kota bandung,Bandung,Antapani,75,86,914000000,161,Small
RUMAH INDENT 2 LANTAI PROMO DP 30 JUTA ALL IN,Bandung,Buahbatu,47,50,548300000,97,Small
MILIKI SEGERA HUNIAN NYAMAN DENGAN HARGA TERJANGKAU LOKASI STRATEGIS,Bandung,Soreang,45,83,365000000,128,Small
rumah ready stock 2 lantai full furnished di kota bandung,Bandung,Cidadap,160,200,3000000000,360,Large
hunian islami di lembang dekat bandung kota dan pusat wisata,Bandung,Lembang,65,111,900000000,176,Small
rumah siap huni dan indent konsep free desain,Bandung,,50,72,252000000,122,Small
Dijual Rumah di Jl Cisitu Indah VI  Bandung,Bandung,Coblong,250,728,5600000000,978,Large
JUAL CEPAT RUMAH STRATEGIS HARGA TERBAIK DI CIUMBULEUIT CIDADAP BANDUNG KOTA,Bandung,Ciumbuleuit,100,113,1400000000,213,Medium
Dijual Rumah di Cluster Cikutra,Bandung,Cikutra,50,110,800000000,160,Small
Rumah Batununggal Murah,Bandung,Batununggal,120,180,2400000000,300,Medium
400jutaan rumah Ciganitri Bojongsoang Buahbatu Bandung,Bandung,Buahbatu (Margacinta),50,72,460000000,122,Small
RUMAH SIAP HUNI DI BATU INDAH BATU NUNGGAL KOTA BANDUNG,Bandung,Batununggal,350,513,4700000000,863,Large
Rumah Clasic di Arcamanik,Bandung,Arcamanik,60,77,800000000,137,Small
TERMURAH  Rumah Real Estate 2 Lantai Hanya 500jtan Selangkah Dari Kota Baru,Bandung,Bandung Kulon,60,60,500000000,120,Small
Rumah Industrial style di Kawasan Bandung Timur,Bandung,Cileunyi,36,72,400000000,108,Small
Sayap buah batu  rumah lux mewah dalam komplek nego,Bandung,Buahbatu (Margacinta),400,342,5980000000,742,Large
CLUSTER CIHANJUANG VILLAS,Bandung,Parongpong,45,105,395000000,150,Small
Rumah Mewah Emaralda Resort Cluster Janet Park,Bandung,Bandung Kulon,75,84,750000000,159,Small
Dijual Rumah Jl AYani Mainroad,Bandung,Antapani,210,220,2375000000,430,Large
The Emeralda ResortThe Private Residence,Bandung,,75,84,500000000,159,Small
Jangan beli di sini awas nanti kalian puas,Bandung,Paledang,75,84,700000000,159,Small
MURAH RUMAH DI CIBIRU HILIR BANDUNG,Bandung,Cibiru Hilir,85,65,340000000,150,Small
BeliRumah dapat mobil Ayla,Bandung,Ujung Berung,55,60,525000000,115,Small
Rumah Sarijadi SHM dkt Tol Pasteur dalam gang Cijerokaso murah,Bandung,Sarijadi,50,67,525000000,117,Small
Komplek Aria Graha Soekarno Hatta,Bandung,Soekarno Hatta,90,100,1250000000,190,Small
RUMAH BAGUS CANTIK,Bandung,Bojongsoang,72,100,544000000,172,Small
Konsep Rumah Unik Bumi Panenjoan Cicalengka Promo DP 1 JT All In,Bandung,,30,66,319000000,96,Small
DIJUAL CEPAT NEGO SAMPAI DEAL RUMAH BAGUS DAN ASRI BISA TEMPAT USAHA,Bandung,Soreang,180,120,1250000000,300,Large
Cibiru Village Perumahan Cluster Ekslusif,Bandung,Cibiru Wetan,40,64,375000000,104,Small
RUMAH 2 TINGKAT MINIMALIS DI BANDUNG DEKAT UNIVERSITAS TELKOM UNIT TERBATAS,Bandung,Bojongsoang,40,47,395000000,87,Small
Laris Cluster Emily Hunian Tipe Esyana Mewah Di Kota Bandung,Bandung,Gedebage,300,375,600000000,675,Large
Jual Rumah di Bandung,Bandung,Gedebage,80,91,1800000000,171,Small
DIJUAL Rumah Minimalis di Tatar Banyak Sumba Kota Baru Parahyangan,Bandung,Padalarang,120,108,1800000000,228,Medium
Dijual Rumah Siap Huni di Tengah Kota  Sayap Jalan Riau Bandung,Bandung,Cihapit,300,204,4900000000,504,Large
Rumah nyaman dengan harga terjangkau,Bandung,Ciwastra,32,62,250000000,94,Small
JUAL RUMAH MATON HOUSE NYAMAN DI BANDUNG,Bandung,Cigadung,65,72,680000000,137,Small
DIJUAL RUMAH MINIMALIS BATU INDAH BATUNUNGGAL,Bandung,Batununggal,150,116,1500000000,266,Medium
Perumahan Guntursari Buah batu Bandung,Bandung,Lengkong,106,211,4000000000,317,Medium
Dijual Rumah Nyaman di Pusat Kota Sayap Buah Batu Bandung,Bandung,Turangga,120,200,2400000000,320,Medium
Rumah Lux Batik Kumeli Sukaluyu,Bandung,Cibeunying Kaler,750,535,12750000000,1285,Large
DiJUAL RUMAH  DI BANDUNG TIMUR,Bandung,Bojongloa Kaler,40,72,430000000,112,Small
Rumah klasik dg konsep Santorini Yunani PERTAMA DI INDONESIA,Bandung,Ciparay,75,84,720000000,159,Small
Rumah Murah Sukamenak,Bandung,Margahayu,70,86,425000000,156,Small
DIJUAL PERUMAHAN MEWAH TERJANGKAU DI BANDUNG,Bandung,Soreang,45,83,400000000,128,Small
HUNIAN ASRI MODERN 2 LANTAI STOCK TERBATAS,Bandung,Bandung Wetan,45,45,490000000,90,Small
SALAM DARI CILEUNYI HUNIAN INI BIKIN KAMU NYAMAN DAN BETAH YUK CEK SEKARANG,Bandung,Cileunyi,66,72,400000000,138,Small
Rumah mewah 2 lantai di arcamanik dekat bandung kota,Bandung,Arcamanik,75,84,865000000,159,Small
Dijual Rumah Siap Huni Di Dago Village Bandung,Bandung,Dago,150,310,1950000000,460,Medium
Rumah Betul Betul Siap Huni,Bandung,Banjaran,64,90,370000000,154,Small
Rumah smart modern tatar tarubhawana kota baru parahyangan bandung,Bandung,Padalarang,94,120,1999204999,214,Medium
Dijual rumah hitung tanah di daerah hegarmanah,Bandung,Hegarmanah,350,350,8000000000,700,Large
RUMAH CANTIK TERAWAT DI BELAKANG MTC KOMPLEK MARGAHAYU METRO HARGA BISA NEGO,Bandung,Margahayu,102,80,750000000,182,Medium
JUAL RUMAH NYAMAN ASRI DI KOTA BANDUNG,Bandung,Regol,65,72,680000000,137,Small
Dijual Rumah Baru Cluster Pinggir Jalan Raya tipe 21,Bandung,Batujajar,21,104,462000000,125,Small
Dijual Rumah Baru,Bandung,Kopo,80,70,850000000,150,Small
Unit Full Furnished di Sarijadi Pasteur Kota Bandung,Bandung,Sarijadi,144,172,3500000000,316,Medium
Rumah Cibiru Bandung Timur,Bandung,Cibiru Wetan,40,63,345000000,103,Small
RUMAH MURAH MINIMALIS DI BANDUNG TIMUR,Bandung,Cileunyi,40,63,345000000,103,Small
jual cepat rumah siap huni dan asri cisitu town house dago,Bandung,Dago,300,138,1950000000,438,Large
RUMAH MURAH REDY STOK BUAHBATU,Bandung,Bojongsoang,30,42,241000000,72,Small
Rumah Di jual di Pasir Jati,Bandung,,180,107,1000000000,287,Large
Jual Rumah Minimalis Top Regency,Bandung,,120,120,850000000,240,Medium
CLUSTER MODERN MINIMALIS TERMURAH  TERDEKAT DENGAN PODOMORO PARK BUAH BATU,Bandung,Bojongsoang,36,50,277000000,86,Small
Rumah Cluster Chiisana Sakura Griya Pratama Asri Cileunyi 2 Bandung Timur,Bandung,Cileunyi Kulon,36,60,372000000,96,Small
Rumah Daerah Rancasari Bandung 2 Lantai Minimalis Modern,Bandung,Rancasari,45,65,675000000,110,Small
Unit Full Furnished Rumah mewah di setiabudi bandung dekat UPI,Bandung,Setiabudi,160,200,3000000000,360,Large
Rumah Siap Huni TKI 1,Bandung,Kopo,100,102,900000000,202,Medium
Rumah di Komplek Bumi Panyawangan Cileunyi Bandung,Bandung,Cileunyi,100,105,850000000,205,Medium
Rumah Cantik Minimalis Siap Huni Resort Dago Pakar Bandung,Bandung,Dago,175,174,2300000000,349,Large
Rumah Tropical Industrial 300Jutaan di Pasir Jati Cilengkrang,Bandung,Cilengkrang,50,72,595000000,122,Small
Jual Rumah Lama Terawat Dilokasi Strategis Rajamantri Turangga,Bandung,Turangga,210,399,4750000000,609,Large
Perumahan Bandung  Galeri Buahbatu,Bandung,Buahbatu,38,77,405000000,115,Small
Jual rumah villa cantik harga 37 M Nego Dago,Bandung,Dago,400,253,3700000000,653,Large
Hunian Asri Di Kota Bandung Dengan View Yang Keren Memanjakan Mata,Bandung,Arcamanik,36,72,460000000,108,Small
DIJUAL RUMAH PASTEUR  KOTA BANDUNG,Bandung,Pasteur,380,350,6250000000,730,Large
Rumah Nyaman Budisari,Bandung,Setiabudi,200,300,4000000000,500,Large
RUMAH SIAP HUNI  Almaas 3,Bandung,Kopo,80,120,460000000,200,Small
jual rumah siap huni citra green dago,Bandung,Dago,200,200,2950000000,400,Large
Promo Tahun Baru Rumah Cluster Mewah harga Subsidi Dekat Tol Seroja,Bandung,Soreang,40,84,350000000,124,Small
RUMAH MINIMALIS 2 LANTAI DI KODYA BANDUNG HANYA 20 MENIT KE TSM BANDUNG,Bandung,Rancasari,82,90,1436340000,172,Small
Rumah minimalis harga terjangkau dibandung,Bandung,Baleendah,36,50,150000000,86,Small
RECOMMENDED   RUMAH KOPO PERMAI MINIMALIS MODERN,Bandung,Kopo,90,91,950000000,181,Small
Rumah Idaman Para Milenial Angsuran 2 Jt Dapat Rumah 2 Lantai Buah Bat,Bandung,Ciwastra,50,60,395907908,110,Small
Jual Rumah Cluster Sayap Taman Kopo Indah Bandung,Bandung,Margahayu,48,96,670000000,144,Small
Rumah cimahi 400 jt an dekat IKEA Padalarang Bandung Barat,Bandung,Padalarang,36,72,435000000,108,Small
Jual rumah nyaman di komplek GBI,Bandung,Buahbatu,40,60,380000000,100,Small
DISKON HINGGA 60 JUTA Rumah Eropa desain Medieran Ciganitri Bandung,Bandung,Bojongsoang,50,2,557000000,52,Small
rumah siap huni dan siap bangun di katapang,Bandung,Katapang,80,120,311000000,200,Small
Rumah Murah Green City Resort 2 Sindanglaya Bandung Timur,Bandung,Sindanglaya,36,72,460000000,108,Small
Jual Rumah Cikutra dekat Jalan Utama,Bandung,Cibeunying Kaler,100,112,999000000,212,Medium
Dijual Rumah Large Klasik di Jalan Utama Cipaganti Kota Bandung,Bandung,Cipaganti,600,1367,41500000000,1967,Large
Cinunuk  Bandung Timur,Bandung,Cileunyi,54,70,577000000,124,Small
GRATIS UMROHINTERNET Rumah Dua Lantai Ciganitri Bandung,Bandung,Bojongsoang,50,60,557000000,110,Small
Jual Rumah  Baru posisi Hook 2 Kamar Tidur  Dayana Summarecon Bandung,Bandung,,62,108,1650000000,170,Small
Dijual Rumah Mewah 2 Lantai 500 jtan Dekat Tol Dan wisata Serta Pendi,Bandung,Padalarang,600,60,500000000,660,Large
Rumah Design Skandinavia harga Promo Special Tahun Baru,Bandung,,38,68,626000000,106,Small
Jual Rumah Berkonsep Office di Podomoro Park Bandung Tipe Amala Eka,Bandung,Buahbatu,73,90,1600000000,163,Small
Rumah Strategis di Pusat Kota Bandung,Bandung,Lengkong,190,257,3250000000,447,Large
Rumah Minimalis Harga Bersahabat Lokasi Sayap Kopo,Bandung,Kopo,70,55,575000000,125,Small
RUMAH BAGUS MINIMALIS NYAMAN DI PONDOK PADALARANG INDAH BANDUNG BARAT,Bandung,Padalarang,151,151,675000000,302,Large
Rumah Baru Dekat SMA 8 Bandung Blakang Horison Kliningan Turangga Buahbatu,Bandung,Turangga,160,100,2200000000,260,Large
Dp 5 juta sampai terima kunci rancaekek promo ramadhan,Bandung,Rancaekek,36,60,303000000,96,Small
Rumah 2 lantai view bandung sejuk nyaman strategis jatihandap bandung,Bandung,Bandung Wetan,50,98,496000000,148,Small
KAVLING RANCAMAKMUR,Bandung,Pameungpeuk,36,50,135000000,86,Small
Rumah Strategis Guntur Sari Bandung,Bandung,Buahbatu,250,590,5100000000,840,Large
Jual Cepat Rumah ARCAMANIK Kota Bandung,Bandung,Arcamanik,90,70,575000000,160,Small
RUMAH SIAP HUNI SUDIANG MAKASSAR,Makassar,Biringkanaya,78,90,435000000,168,Small
Ruko strategis ditengah kota,Makassar,,150,150,5500000000,300,Medium
CLUSTER LIVERPOOL  CLUSTER BARU DARI ROYAL SENTRALAND BTP,Makassar,Tamalanrea,27,55,372000000,82,Small
Heppiness Land Future Home,Makassar,Sudiang,49,105,225000000,154,Small
Dijual Rumah Exclusive,Makassar,Tamalate,90,112,1400000000,202,Small
Heppiness Land Future Home,Makassar,Sudiang,49,105,225000000,154,Small
Rumah Tengah Kota Alauddin 2,Makassar,Tamalate,50,75,650000000,125,Small
NUSA HARAPAN PERMAI CLUSTER 3,Makassar,,36,72,419730000,108,Small
RUMAH CLUSTER 2 LANTAI BUKIT BARUGA,Makassar,Antang,90,90,988000000,180,Small
Rumah type 60 1 unit di Dkt poros daya makassar,Makassar,Biringkanaya,60,90,450000000,150,Small
RUMAH MURAH ANTANG,Makassar,Manggala,40,78,350000000,118,Small
ALAMANDA TALLASA CITY HUNIAN MEWAH DENGAN HARGA TERJANGKAU,Makassar,Tamalanrea,38,96,657700000,134,Small
Rumah anti ribet tallasa city fks land,Makassar,Tamalanrea,49,44,713000000,93,Small
RUMAH MEWAH 2LT DIKAWASAN BERGENSI KOTA MANDIRI MAKASSAR 2 MASTER BEDROOM,Makassar,Tamalanrea,182,180,2631000000,362,Large
DIJUAL RUMAH MODEL EROPA DEKAT ROYAL SENTRALAND BTP,Makassar,Tamalanrea,45,78,450000000,123,Small
Rumah full furnish 2 lantai harga 600jtaan dekat poros tallasa city makassar,Makassar,,49,44,699000000,93,Small
rumah murah Makassar Antang manggala,Makassar,Antang,40,78,350000000,118,Small
TREASURE ISLAND  THE OCEANSIDE LIVING Selangkah dari CIPUTRA WORLD MALL,Makassar,Losari,125,102,3468000000,227,Medium
Perumahan tanjung bunga makasar,Makassar,Barombong,33,60,360000000,93,Small
Rumah Mewah dan Murah 2 lantai Bukit Baruga,Makassar,Antang,120,120,1314000000,240,Medium
Rumah 2 lantai dalam kota makassar,Makassar,Mamajang Dalam,155,96,1950000000,251,Large
Dijual cepat  BU rumah Large di Hartaco makassar,Makassar,Tamalate,369,342,1500000000,711,Large
Rumah Cantik 2 Lantai 3kamar tidur 3kamar mandi dikawasan mewah,Makassar,Tamalanrea,107,105,1524000000,212,Medium
rumah murah dekat Makassar,Makassar,Balla Parang,36,78,295000000,114,Small
GREEN CRYSTAL Residence  Rumah Keren  Rumah Pintar,Makassar,Bulurokeng,110,112,1592510000,222,Medium
Rumah dan ruko Tanjung bunga makassar,Makassar,Tanjung Merdeka,33,55,360000000,88,Small
JUAL PERUMAHAN DI MAKASSAR KAWASAN TALLASA CITY,Makassar,Tamalanrea,182,180,2600000000,362,Large
RUMAH 2 LANTAI HARGA 1 LANTAI  TENGAH KOTA MAKASSAR  TANPA RIBA,Makassar,Rappocini,70,67,575000000,137,Small
SMART HOME SYSTEM FULLY FURNISHED DIKAWASAN BERGENSI,Makassar,Tamalanrea Indah,51,48,739000000,99,Small
THE MUTIARA LAGOON HUNIAN RESORT DESAIN TROPIS,Makassar,Daya,133,120,1897080000,253,Medium
Rumah 1 Lantai Murah dan Mewah  Dijual  di BTP Makassar,Makassar,,50,84,450000000,134,Small
Rumah Mewah dan Murah Dijual di Sudiang Makassar dgn Model Cluster Minimalis,Makassar,Sudiang,47,78,400000000,125,Small
Di Jual Murah Rumah Telkomas Kota Makassar,Makassar,Biringkanaya,85,78,497500000,163,Small
Sakura village rumah berteknologi jepang makassar goa ria sudiang type 50,Makassar,Sudiang,50,84,611900000,134,Small
sakura village type 70 goa ria sudiang makassar,Makassar,Sudiang,70,98,875650000,168,Small
RUMAH SIAP HUNI DIKOTA MAKASSAR JALUR STRATEGIS FREE KANOPI,Makassar,Panaikang,50,78,590000000,128,Small
ALAMANDA Tallasa City,Makassar,Tamalanrea,38,96,699000000,134,Small
DIJUAL RUMAH 2 LANTAI DEKAT TOKO MITRA 10 TALLASA CITY,Makassar,Tamalanrea,107,126,1730000000,233,Medium
Mutiara Lagoon hadir dengan konsep Hunian Resort desain Tropis Kontemporer,Makassar,Daya,133,120,1897080000,253,Medium
Sunset Cove  Cluster yang menjadikan pantai sebagai teras rumah Anda,Makassar,Losari,343,300,9619000000,643,Large
CITRALAND TALLASA CITY MAKASSAR TYPE RIVIERA 82105 M2,Makassar,Tamalanrea,82,105,1284000000,187,Small
Rumah Baru di Pinggir Jalan Tanjung Marshmallow,Makassar,Tanjung Merdeka,58,60,800000000,118,Small
Rumah Mewah Siap Huni,Makassar,Antang,160,152,1990000000,312,Large
DIJUAL RUMAH 2 LANTAI DI TAMALANREA DEKAT TOKO INDOGROSIR,Makassar,Tamalanrea,100,105,987000000,205,Medium
RUMAH MODERN LOKASI STRATEGIS 8578 TELKOMAS CASHKREDIT BUNGA CICILAN 0,Makassar,,85,78,950000000,163,Small
Dijual Cepat Rumah Keluarga di Pusat kota Makassar,Makassar,Maricaya,300,333,2800000000,633,Large
DIJUAL CEPAT RUMAH DEKAT TANJUNG BUNGA MAKASSAR,Makassar,Tamalate,130,144,975000000,274,Medium
Rumah dekat bandara Sultan Hasanuddin kota makassar,Makassar,Sudiang Raya,69,108,699000000,177,Small
Rumah eksklusif,Makassar,Antang,152,160,1850000000,312,Large
Rumah Elysium akses Cluster di jalan terlebar di Makassar,Makassar,Tanjung Merdeka,200,200,9100000000,400,Large
JUAL RUMAH MAKASSAR JL RSI FAISAL 9 CLUSTER TYPE 100  PRABOT,Makassar,Rappocini,104,105,985000000,209,Medium
DIJUAL RUMAH 2LT 10X15 DIKAWASAN HERTASNING MAKASSAR SUBSIDI BIAYA BIAYA,Makassar,Rappocini,200,150,1850000000,350,Large
Rumah Mewah bergaya Klasik Eropa dengan harga terjangkau,Makassar,Bulurokeng,64,55,758000000,119,Small
Rumah 500jtaan free biaya2 bonus smart home,Makassar,Tamalanrea,38,72,566000000,110,Small
Rumah murah makassar,Makassar,Biringkanaya,47,78,435000000,125,Small
Rumah dalam kota mandiri tallasa city makassar dekat mall dan sekolah,Makassar,Tamalanrea,55,90,1025000000,145,Small
RUMAH CANTIK 1 LANTAICITRALAND TALLASA CITY MAKASSAR TYPE LAZURITE 105180 M2,Makassar,Tamalanrea,105,180,1904000000,285,Medium
RUMAH LUAS 8X15 4KMR TIDUR PROMO DAN SUBSIDI BIAYA AKAD MANFAATKAN,Makassar,Tamalanrea,65,98,775000000,163,Small
GREEN CRYSTAL Residence Rumah Taman  Rumah Pintar Summarecon Mutiara Makassar,Makassar,Bulurokeng,76,112,1243830000,188,Small
PROMO PERUMAHAN SYARIAH TYPE 3872  TELKOMASTANPA BI CHECKING CASHKREDIT,Makassar,Tamalanrea,38,72,497500000,110,Small
The Mutiara LagoonMakassar,Makassar,Tamalanrea,133,120,1897080000,253,Medium
Dijual Rumah Dekat Bandara Summarecon Mutiara Makassar,Makassar,,72,87,1000000000,159,Small
Rumah Mewah Minimalis Bukit Baruga,Makassar,Manggala,88,105,1200000000,193,Small
Rumah mewah murah di tengah kota mandiri tallasa city makassar,Makassar,Tamalanrea,72,90,1223000000,162,Small
Rumah 2 lantai Tamangapa raya 3 makassar,Makassar,Tamangapa,135,120,1400000000,255,Medium
Perumahan BUKIT BARUGA Makassar Hunian Nyaman  Asri,Makassar,Antang,68,90,987000000,158,Small
RUMAH DIKAWASAN 2 JALUR STRATEGIS DIKOTA MAKASSAR SUBSIDI BIAYA KPR,Makassar,Tamalanrea Indah,40,80,481000000,120,Small
Ruko mewah di pusat kota pecinan kota makassar,Makassar,Wajo Baru,870,286,11500000000,1156,Large
RUMAH MEWAH CITRALAND LOSARI MAKASSAR,Makassar,Losari,123,126,3500000000,249,Medium
RUMAH CANTIK DIJUAL DI CITRALAND CITY LOSARI MAKASSAR,Makassar,,183,162,3500000000,345,Large
RUMAH KEREN DI BTP,Makassar,Tamalanrea,50,84,499000000,134,Small
Berada dikawasan Centre Point of Indonesia yang tertata apik dengan rancangan penghij,Makassar,Losari,126,123,3512000000,249,Medium
ALEXANDRITE TALLASA CITYRumah cantik dikota Makassar,Makassar,Tamalanrea,267,252,4408000000,519,Large
Rumah citraland tallasa city makassar dekat mall sekolah dan universitas,Makassar,Tamalanrea,80,105,1384000000,185,Small
RUMAH 2 LANTAI BERKONSEP INDUSTRIAL  BALCONY HANYA 900 JUTAan ,Makassar,Tamalanrea,60,90,972920000,150,Small
Rumah dalam kota Makassar waduk waduk borong,Makassar,Borong,45,90,495000000,135,Small
CLUSTER TERBARU HARGA PERDANA INGKLUD PERABOT DI TALLASA CITY MAKASSAR,Makassar,Tamalanrea,49,44,699000000,93,Small
HUNIAN EKSKLUSIF 2LT  DI PERINTIS KEMERDEKAAN MURAH DAN BERKUALITAS,Makassar,Biringkanaya,80,105,750000000,185,Small
DIJUAL RUMAH 2 LANTAI DESAIN TROPIS DI KAWASAN PREMIUM DI TAMALANREA MAKASSAR,Makassar,Tamalanrea,133,120,1800000000,253,Medium
Rumah KOMP Bumi permata hijau Alauddin,Makassar,,640,640,3100000000,1280,Large
Citraland Celebes Golden Garnet plus kolam renang,Makassar,,180,210,2500000000,390,Large
Rolling hils makadsar,Makassar,Tamalate,77,105,1700000000,182,Small
Rumah jl Bungur dekat pantai Losari,Makassar,,100,144,2100000000,244,Medium
jl Antang Raya 26x40 mtr,Makassar,,500,1000,3800000000,1500,Large
TIPE TERLARIS 3 KAMAR UTAMA CITRALAND TALLASA CITY MAKASSAR TIPE AQUAMARINE,Makassar,Tamalanrea,182,180,2613000000,362,Large
JUAL RUMAH 2 LANTAI DI DAERAH TAMALANREA MAKASSAR,Makassar,Tamalanrea,267,252,3900000000,519,Large
Rumah Mewah Bukit Baruga,Makassar,Manggala,160,152,2000000000,312,Large
Rumah Puri mutiara Monginsidi,Makassar,,150,135,2800000000,285,Medium
Dijual Perumahan Syariah Hertasning Kota Makassar,Makassar,Manggala,288,135,1200000000,423,Large
Rumah Griya Fajar mas Alauddin,Makassar,,54,126,675000000,180,Small
RUMAH DALAM KOTA MAKASSAR SIAP HUNI SUBSIDI SEMUA BIAYA BIAYA,Makassar,Bongaya,45,72,672700000,117,Small
De mutiara Pettarani Makassar,Makassar,,250,200,6000000000,450,Large
The Mutiara Lagoon Hunian Resort,Makassar,Daya,133,120,1897080000,253,Medium
Rumah 3 Kamar Type Padma Di Bukit Baruga,Makassar,Antang,120,120,1704000000,240,Medium
TIPE TERLARIS TYPE MARIGOLD CITRALAND TALLASA CITY MAKASSAR,Makassar,Tamalanrea,72,90,1097000000,162,Small
TIPE TERLARIS CITRALAND TALLASA CITY MAKASSAR TYPE ORCHID 107126 M2,Makassar,Tamalanrea,107,126,1640000000,233,Medium
jl Faisal 12 Makassar,Makassar,,150,350,2300000000,500,Medium
SUNSET COVE SPLENDID OCEANSIDE LIVING,Makassar,Losari,343,300,9619000000,643,Large
The Mutiara Lagoon Hunian Resort,Makassar,Daya,133,120,1897080000,253,Medium
The Mutiara Lagoon Hunian Resort,Makassar,Daya,133,120,1897080000,253,Medium
Rumah insignia Residence perintis kemerdekaan,Makassar,,150,150,3000000000,300,Medium
Jl Wijaya Kusuma poros,Makassar,,120,354,2400000000,474,Medium
Rumah jl Hertasning 3 lantai,Makassar,,150,120,1300000000,270,Medium
The Mutiara Lagoon Hunian Resort,Makassar,Daya,133,120,1897080000,253,Medium
Rumah 2 lantai heetasning baru,Makassar,Manggala,100,91,850000000,191,Medium
Rumah sekitaran BTP makassar,Makassar,Tamalanrea,45,72,320000000,117,Small
DIJUAL RUMAH MODEL MINIMALIS MODERN DI TAMALANREA DEKAT JALAN PERINTIS,Makassar,Tamalanrea,49,44,699000000,93,Small
TIPE TERLARIS TYPE PORTOFINO 6090 M2 CITRALAND TALLASA CITY MAKASSAR,Makassar,Tamalanrea,60,90,1008000000,150,Small
TINGGAL 2 UNIT LAGICITRALAND TALLASA CITY MAKASSAR TYPE ALEXANDRITE 267252 M2,Makassar,Tamalanrea,252,267,3741000000,519,Large
Rumah murah 2 lantai,Makassar,,88,105,987000000,193,Small
RUMAH 2 LANTAI DAYA,Makassar,Daya,80,78,695000000,158,Small
DI JUAL RUMAH 2 LANTAI FREE BIAYA KPR FREE LOGAM MULIA FREE VOUCHER BELANJA,Makassar,Tamalanrea,60,90,980000000,150,Small
JUAL RUMAH DI TAMALANREA MAKASSAR KAWASAN TALLASA CITY,Makassar,Tamalanrea,120,122,1888000000,242,Medium
NEW SMART HOME SYSTEM FULLY FURNISHED DITALLASA CITY MAKASSAR,Makassar,Tamalanrea,51,44,739000000,95,Small
Rumah siap huni makassar,Makassar,Manggala,36,84,459000000,120,Small
JUAL RUMAH SIAP HUNI DI DAERAH TAMALANREA MAKASSAR,Makassar,Tamalanrea,162,74,1366000000,236,Large
DIJUAL RUMAH 2 LANTAI DI KAWASAN STRATEGIS DEKAT TOLL MAKASSAR,Makassar,Tamalanrea,148,134,2149000000,282,Medium
RUMAH CANTIK 2LTDALAM KOTA MAKASSAR MURAH  FREE BIAYA BIAYA,Makassar,Jongaya,60,94,1007000000,154,Small
Rumah bergaya modern minimalis di Moncongloe BTP Makassar,Makassar,Tamalanrea,45,72,320000000,117,Small
RUMAH MEWAH SUMMARECON MAKASSAR,Makassar,Biringkanaya,96,84,1200000000,180,Medium
RUMAH 3 KAMAR BUKIT BARUGA,Makassar,Manggala,88,105,1230000000,193,Small
PROMO PERUMAHAN SYARIAH TYPE 3160  TELKOMASTANPA BI CHECKING CASHKREDIT,Makassar,Tamalanrea,31,60,427500000,91,Small
Rumah Premium 2 Lantai Kota Makassar Type Sherry Summarecon,Makassar,,89,77,1325000000,166,Small
JUAL PERUMAHAN CANTIK STRATEGIS DI KAWASAN TALLASA CITY TAMALANREA MAKASSAR,Makassar,Tamalanrea,65,120,1027000000,185,Small
RUMAH 2LT PERINTIS KEMERDEKAAN MAKASSAR HARGA 800JUTAAN,Makassar,Tamalanrea,60,98,792000000,158,Small
Citraland Tallasa City  Aquamarine,Makassar,Tamalanrea,182,180,2500000000,362,Large
GRIYA HARAPAN PAMPANG,Makassar,Pampang,145,118,1325000000,263,Medium
Rumah Kawasan Premium Citraland Makassar,Makassar,Tamalanrea,36,66,698000000,102,Small
DIJUAL RUMAH CANTIK 2 LANTAI LOKASI PREMIUM DEKAT  POROS PERINTIS KEMERDEKAAN,Makassar,Tamalanrea,150,120,2100000000,270,Medium
Cluster Terbaru The Topaz Summarecon Mutiara Makassar,Makassar,Biringkanaya,64,55,760000000,119,Small
RUMAH SIAP HUNI DEPAN SMA 10 MAKASSAR FREE BIAYA  SURAT2 SAMPAI SHM,Makassar,Antang,50,90,450000000,140,Small
Rumah Murah desain Mewah 2 Lantai Makassar,Makassar,Manggala,68,90,765000000,158,Small
Topaz Residence Summarecon Mutiara Makassar,Makassar,,64,55,760000000,119,Small
Green Crystal Summarecon Mutiara Makassar,Makassar,,96,112,1249580000,208,Medium
rumah 2 lantai samping kampus Unhas makassar,Makassar,Tamalanrea Jaya,75,72,715000000,147,Small
RUMAH SIAP HUNI TODDOPULI,Makassar,Panakkukang,100,98,1350000000,198,Medium
CITRALAND TALLASA CITY MAKASSAR TYPE AMETHYST 220180 M2,Makassar,Tamalanrea,220,180,2974000000,400,Large
JUAL RUMAH LOKASI TAMALANREA DEKAT DENGAN BANDARA HASANUDDIN,Makassar,Tamalanrea,36,72,717000000,108,Small
Rumah Minimalis dikota MakassarNEMESIA,Makassar,Tamalanrea,80,105,1308000000,185,Small
DIJUAL RUMAH MODEL MINIMALIS DI TAMALANREA KAWASAN TALLASA CITY,Makassar,Tamalanrea,49,96,764000000,145,Small
DIJUAL RUMAH 2 LANTAI DI TAMALANREA DEKAT RS WAHIDIN,Makassar,Tamalanrea,107,126,1698000000,233,Medium
Rumah 2 lantai type 68,Makassar,Antang,68,90,765000000,158,Small
RUMAH SIAP HUNI TANJUNG BUNGA,Makassar,Tamalate,250,200,4500000000,450,Large
Rumah Murah Bukit Baruga 2 lantai,Makassar,Manggala,160,152,1800000000,312,Large
Rumah tipe 38 2kamar tidur dikawasan kota Mandiri,Makassar,,38,72,641600000,110,Small
Rumah Dekat Asrama haji Sudiang,Makassar,Sudiang Raya,76,102,650000000,178,Small
RUMAH MEWAH DI HERTASNING BARU,Makassar,,98,135,2000000000,233,Medium
RUMAH MEWAH DICITRALAND TALLASA CITY MAKASSAR,Makassar,Tamalanrea,267,252,3913000000,519,Large
CITRALAND TALLASA CITY MAKASSAR TYPE NEMESIA 80105 M2,Makassar,Tamalanrea,80,105,1241000000,185,Small
Rumah 2 lantai type 88,Makassar,Antang,88,105,987000000,193,Small
Miliki Segera Rumah Berlantai 2 Dua Yang Berlokasi Di Kawasan Timur Kota Makassar ,Makassar,Manggala,68,90,765000000,158,Small
Rumah 2 lantai murah,Makassar,Manggala,68,90,765000000,158,Small
Rumah 2 lantai di jalan kumala makassar,Makassar,Jongaya,60,91,925000000,151,Small
Rumah murah 2 lantai di kota makassar,Makassar,Sudiang,80,104,791000000,184,Small
PROMO PERUMAHAN SYARIAH TYPE 8578  TELKOMASTANPA BI CHECKING CASHKREDIT,Makassar,Tamalanrea,85,78,950000000,163,Small
PROMO PERUMAHAN SYARIAH TYPE 3872  TELKOMASTANPA BI CHECKING CASHKREDIT,Makassar,Tamalanrea Jaya,38,72,497500000,110,Small
RUMAH 2 LANTAI BELAKANG POLDA SUDIANG,Makassar,Biringkanaya,80,108,798000000,188,Small
Summarecon Mutiara MAKASSAR,Makassar,,89,77,1100000000,166,Small
RUMAH 2 LANTAI DEKAT KAMPUS UMI,Makassar,Panakkukang,150,119,1300000000,269,Medium
RUMAH MINIMALIS DIKOTA MAKASSARHORTENSIA Tallasa City Makasssar,Makassar,Tamalanrea,85,120,1572000000,205,Small
RED TERRACOTTASICILY,Makassar,Tamalanrea,107,105,1639000000,212,Medium
CITRALAND TALLASA CITY MAKASSAR TYPE JASMINE 162135 M2,Makassar,Tamalanrea,135,162,2213000000,297,Medium
CITRALAND TALLASA CITY TYPE HORTENSIA DELUXE 85120 M2,Makassar,Tamalanrea,85,120,1399000000,205,Small
DIJUAL RUMAH LOKASI DEKAT TOLL TALLASA CITY TAMALANREA MAKASSAR,Makassar,Tamalanrea,38,96,692000000,134,Small
Rumah mewah 2 lantai murah,Makassar,Antang,88,105,987000000,193,Small
DIJUAL RUMAH 2 LANTAI DI TALLASA CITY SANGAT DEKAT KAMPUS UNHAS TAMALANREA,Makassar,Tamalanrea,60,90,1137000000,150,Small
Rumah 2 lantai type 120,Makassar,Antang,120,120,1314000000,240,Medium
CITRALAND TALLASA CITY MAKASSAR TYPE UMBRIA 148135 M2,Makassar,Tamalanrea,148,135,2088000000,283,Medium
Rumah mewah murah,Makassar,Manggala,152,160,1850000000,312,Large
DIJUAL RUMAH DI TAMALANREA 2 LANTAI DEKAT TOLL MAKASSAR,Makassar,Tamalanrea,162,135,2303000000,297,Large
RUMAH MEWAH  SIAP HUNI DENGAN FASILITAS LENGKAP DI MAKASSAR,Makassar,Manggala,160,152,1850000000,312,Large
Rumah dengan Komsep Modern,Makassar,Tamalanrea,82,105,1334000000,187,Small
Rumah Makassar Kawasan Tallasa City Makassar Cluster Alamanda 6x16m Dp mulai 3,Makassar,Ujung Pandang Baru,38,96,671000000,134,Small
RUMAH CANTIK LUAS 8X15 4KMR TIDUR SUBSIDI BIAYA BIAYA LOKASI STRATEGIS,Makassar,Tamalanrea,65,120,971400000,185,Small
BARU HARGA PERDANA RUMAH 1LT DICITRALAND TALLASA MAKASSAR,Makassar,Tamalanrea,36,90,818000000,126,Small
Perumahan minimalis full fasilitas,Makassar,Tamalanrea,27,55,371000000,82,Small
CITRALAND TALLASA CITY MAKASSAR TYPE NEW CALDERIA 64120 M2,Makassar,Tamalanrea,64,120,1262000000,184,Small
CITRALAND TALLASA CITY MAKASSAR TYPE SICILY 107105 M2,Makassar,Tamalanrea,107,105,1535000000,212,Medium
TIPE TERLARIS 2 KAMAR UTAMA CITRALAND TALLASA CITY MAKASSAR TIPE AQUAMARINE,Makassar,Tamalanrea,182,180,2613000000,362,Large
Rumah cantik dikota makassartallasa city Makassar,Makassar,Tamalanrea,162,135,2593000000,297,Large
RUMAH MURAH 2 LANTAI PANAIKANG,Makassar,Panakkukang,70,84,645000000,154,Small
RUMAH SIAP HUNI MINASA UPA,Makassar,Rappocini,70,100,750000000,170,Small
Citraland tallasa city kota makassar,Makassar,Tamalanrea,182,180,2500000000,362,Large
Rumah 2 lantai dekat pasar daya makassar,Makassar,Panakkukang,100,98,1350000000,198,Medium
JUAL RUMAH TALLASA CITY MAKASSAR PINGGIR JALAN POROS,Makassar,Tamalanrea,80,300,5420000000,380,Small
JUAL RUMAH AREA MAKASSAR KAWASAN TALLASA CITY,Makassar,Tamalanrea,65,120,1100000000,185,Small
Rumah di sekitar Antang Makassar,Makassar,,45,72,320000000,117,Small
Rumah dekat RS Wahidin Sudirohusodo,Makassar,Tamalanrea,45,72,320000000,117,Small
JUAL RUMAH DEKAT TRANS STUDIO MAKASSAR,Makassar,Tanjung Merdeka,77,105,1600000000,182,Small
JUAL RUMAH DEKAT PASAR DAYA MAKASSAR,Makassar,Tamalanrea,150,120,2100000000,270,Medium
JUAL RUMAH DI JALAN BANTA BANTAENG MAKASSAR,Makassar,Rappocini,800,635,4400000000,1435,Large
Summarecon Mutiara Makassar  Cluster Green Crystal,Makassar,Biringkanaya,76,112,1250845000,188,Small
PERTAMA DI MAKASSAR RUMAH CANTIK 2LT  ALA RESORT AKSES LANGSUNG KOLAM RENANG,Makassar,Biringkanaya,120,133,1897000000,253,Medium
Rumah Baru Pantai Citraland Losari Makassar,Makassar,Losari,123,126,3565000000,249,Medium
RUMAH DI JUAL DI MAKASSAR DAERAH PERINTIS,Makassar,Tamalanrea,49,96,700000000,145,Small
DIJUAL RUMAH DI MAKASSAR DEKAT KAMPUS STIEM BONGAYA,Makassar,Tamalate,78,93,1077000000,171,Small
JUAL RUMAH TALLASA CITY MAKASSAR DEKAT TOKO MITRA 10,Makassar,Tamalanrea,80,105,1288000000,185,Small
JUAL RUMAH DI JALAN PERINTIS KEMERDEKAAN MAKASSAR,Makassar,Daya,80,78,735000000,158,Small
HUNIAN THE TOPAZ RESIDANCE MAKASSAR,Makassar,Biringkanaya,96,84,1266860000,180,Medium
Rumah 2 lantai peritis 7 kota makassar,Makassar,Tamalanrea,75,72,665000000,147,Small
RUMAH DIJUAL DEKAT PANAKUKKANG MAKASSAR,Makassar,,192,200,2800000000,392,Large
RUMAH DI JUAL DI CITRALAND TALLASA CITY MAKASSAR,Makassar,Tamalanrea,162,135,2303000000,297,Large
JUAL RUMAH DEKAT BANDARA SULTAN HASANUDDIN MAKASSAR,Makassar,Biringkanaya,60,96,667000000,156,Small
RUMAH CANTIK 2LT ALA RESORT PERTAMA DIMAKASSAR,Makassar,Biringkanaya,133,120,1897000000,253,Medium
Rumah modern minimalis di perbatasan makassar maros,Makassar,,45,72,320000000,117,Small
RUMAH MURAH SUDIANG DG RAMANG,Makassar,Biringkanaya,47,78,435000000,125,Small
rumah ready unit Sudiang makassar,Makassar,Sudiang,48,72,485000000,120,Small
RUMAH DEKAT HERTASNING BARU,Makassar,Manggala,45,60,599900000,105,Small
Rumah tengah kota makassar Uripsumoharjo,Makassar,Panaikang,145,118,1325000000,263,Medium
Di Jual Tallasa City,Makassar,Tamalanrea,37,72,540700000,109,Small
Rumah 2 lantai murah kota makassar,Makassar,Biringkanaya,68,84,658000000,152,Small
Rumah mewah tengah kota Makassar jln mongsidi baru,Makassar,Maricaya Baru,165,144,3900000000,309,Large
Kumala Residence,Makassar,Tamalate,45,78,691700000,123,Small
ALAMANDA TALLASA CITY  INVESTASI TERBAIK MASA DEPAN,Makassar,Tamalanrea,38,72,699000000,110,Small
Rumah Siap Huni Di Makassar,Makassar,Manggala,60,90,610000000,150,Small
RUMAH DEKAT KE HERTASNING BARU,Makassar,Manggala,36,84,460000000,120,Small
RUMAH SIAP HUNI TAMANGAPA MAKASSAR,Makassar,Tamangapa,60,90,615000000,150,Small
Rumah siap huni dekat kampus umi makassar,Makassar,Pampang,50,79,675000000,129,Small
Summarecon Mutiara Makassar,Makassar,Biringkanaya,64,55,792000000,119,Small
Sherry Summarecon Mutiara Makassar,Makassar,Biringkanaya,89,77,1169000000,166,Small
RUMAH READY UNIT SUDIANG,Makassar,Pai,48,72,485000000,120,Small
RUMAH READY UNIT DG TATA,Makassar,Tamalate,78,107,1292000000,185,Small
Rumah ready dekat hertasning baru,Makassar,Manggala,36,84,459900000,120,Small
Rumah siap huni sudiang,Makassar,Sudiang Raya,48,72,455000000,120,Small
RUMAH SIAP HUNI TAMANGAPA MAKASSAR,Makassar,Tamangapa,45,72,490000000,117,Small
RUMAH 2 LANTAI PANAIKANG MAKASSAR,Makassar,Panaikang,70,84,645000000,154,Small
Rumah di panaikang makassar,Makassar,Panaikang,45,78,427000000,123,Small
rumah ready unit belakang kampus umi kota makassar,Makassar,Panakkukang,60,90,675000000,150,Small
Rumah siap huni dekat hertasning,Makassar,Bangkala,45,90,599900000,135,Small
RUMAH 2 LANTAI DEKAT KAMPUS UNHAS,Makassar,Tamalanrea,75,72,715000000,147,Small
RUMAH DEKAT KAMPUS UMI,Makassar,Pampang,50,79,675000000,129,Small
RUMAH 2 LANTAI BELAKANG POLDA,Makassar,Biringkanaya,68,84,698000000,152,Small
Rumah siap huni dekat hertasning,Makassar,Manggala,45,90,599900000,135,Small
Alamanda Tallasa City Makassar,Makassar,Tamalanrea,49,96,772000000,145,Small
Summarecon Mutiara Makassar Green Crystal,Makassar,Biringkanaya,112,160,2057000000,272,Medium
Golden Avenue Citraland City Losari Makassar  Limited Unit,Makassar,Mariso,151,126,3849000000,277,Large
RUMAH CLUSTER CLOVE TANJUNG BUNGA,Makassar,Tamalate,116,120,2700000000,236,Medium
RUMAH MEWAH BERADA DLM CLUSTER GMTD TANJUNG BUNGA,Makassar,Tamalate,562,312,6500000000,874,Large
Alamanda  Tallasa  City Perintis Makassar,Makassar,Tamalanrea,38,96,699000000,134,Small
Green Crystal  Summarecon mutiara Makassar,Makassar,Biringkanaya,73,84,1190000000,157,Small
rumah murah 2 lanati lokasi daya makassar,Makassar,Daya,80,78,735000000,158,Small
rumah ready unit depan Polda sudiang makassar,Makassar,Sudiang Raya,42,72,598000000,114,Small
RUMAH 2 LANTAI SUDIANG,Makassar,Biringkanaya,69,105,699000000,174,Small
RUMAH DP MULAI 25 JUT HERTASNING BARU,Makassar,Bangkala,40,78,500000000,118,Small
RUMAH SIAP HUNI,Makassar,Tamangapa,60,90,615000000,150,Small
RUMAH SIAP HUNI DEKAT KE HERTASNING,Makassar,Manggala,45,90,599900000,135,Small
RUMAH 2 LANTAI DEKAT UNHAS,Makassar,Tamalanrea,75,72,715000000,147,Small
Rumah siap Huni Toddopuli,Makassar,Panakkukang,100,98,1350000000,198,Medium
Alamanda Tallasa City Makassar,Makassar,Tamalanrea,65,120,1032000000,185,Small
Summarecon Mutiara Makassar,Makassar,Biringkanaya,64,65,1076000000,129,Small
Summarecon Mutiara  Green Crystal  Makassar,Makassar,Biringkanaya,110,112,1406000000,222,Medium
PERUMAHAN BUKIT BARUGA  TYPE PADMA  GRATIS KANOPI  3 AC,Makassar,Antang,120,120,1700000000,240,Medium
Summarecon mutiara kota makassar,Makassar,Biringkanaya,74,84,1200000000,158,Small
RUMAH DEPAN POLDA SUDIANG,Makassar,Biringkanaya,42,72,598000000,114,Small
RUMAH SIAP HUNI,Makassar,Manggala,36,84,459900000,120,Small
Rumah panaikang makassar,Makassar,Panaikang,45,78,427000000,123,Small
RUMAH READY STOCK,Makassar,Manggala,36,84,460000000,120,Small
Rumah Murah Barombong  Ville Park,Makassar,Tamalate,45,1,458000000,46,Small
Rumah mewah Hertasning makassar,Makassar,Kassi - Kassi,118,78,900000000,196,Medium
Rumah keren di tallasa city kota makassar,Makassar,Kapasa,49,96,781000000,145,Small
Rumah 2 lantai makassar,Makassar,Parang Tambung,60,91,1100000000,151,Small
Dijual Rumah Summarecon Mutiara Makassar,Makassar,,95,87,1100000000,182,Medium
Rumah baru siap huni Di antang makassar,Makassar,,45,78,455000000,123,Small
Rumah mewah Toddopuli makassar,Makassar,Panakkukang,97,100,956000000,197,Medium
Rumah 2 lantai Citraland tallasa city makassar,Makassar,Tamalanrea,80,105,1250000000,185,Small
RUMAH MEWAH SIAP HUNI DI KOTA MAKASSAR DEKAT METRO TANJUNG BUNGA,Makassar,Tamalate,140,105,1745000000,245,Medium
Rumah murah makassar daya,Makassar,Kapasa,80,78,695000000,158,Small
Rumah 2 lantai kota makassar,Makassar,Borong,70,84,899000000,154,Small
Rumah di daya makassar,Makassar,Biringkanaya,49,72,420000000,121,Small
Rumah DI depan SMA 10 MAKASSAR,Makassar,,45,78,490000000,123,Small
Malino Wonderland empatnya satusatunya Kawasan Islami TERPADU dan TerLarge di,Makassar,,32,88,350000000,120,Small
PERUMAHAN BUKIT BARUGA  SUPER PROMO FREE SMART HOME KANOPI AC ,Makassar,Antang,120,120,1700000000,240,Medium
Rumah mewah cendrawasi kota makassar,Makassar,Mariso,140,116,1827800000,256,Medium
Lokasi Toddopuli,Makassar,Panakkukang,100,98,1350000000,198,Medium
Rumah Dp 21 jutaan,Makassar,Tamangapa,40,72,432000000,112,Small
Rumah murah 2 lantai panaikang,Makassar,Panaikang,70,84,685000000,154,Small
RUMAH DALAM CLUSTER,Makassar,Tamalate,45,105,850000000,150,Small
RUMAH LAYAK HUNI,Makassar,Rappocini,234,135,2200000000,369,Large
Rumah 2 lantai panaikang,Makassar,Panaikang,70,84,645000000,154,Small
RUMAH 2 LANTAI DAYA MAKASSAR,Makassar,Biringkanaya,80,78,735000000,158,Small
Rumah cantik panaikang makassar,Makassar,Panaikang,45,78,465000000,123,Small
RUMAH SIAP HUNI TODDOPULI,Makassar,Panakkukang,100,98,1350000000,198,Medium
Tallasa city makassar,Makassar,Biringkanaya,38,96,699000000,134,Small
Alamanda Tallasa City Makassar,Makassar,Tamalanrea,38,96,699000000,134,Small
RUMAH TENGAH KOTA,Makassar,Losari,123,126,3565000000,249,Medium
RUMAH COCOK UTK RHM KOST,Makassar,Tidung,300,300,2500000000,600,Large
RUMAH LAYAK HUNI DLM KOTA,Makassar,Tidung,400,369,3500000000,769,Large
RUMAH DALAM CLUSTER,Makassar,Tanjung Merdeka,70,126,1000000000,196,Small
RUMAH DALAM KOTA,Makassar,Lariang Bangi,96,128,1100000000,224,Medium
RUMAH DALAM KOTA SIAP HUNI,Makassar,Jongaya,70,126,978000000,196,Small
Hanya 600jutaan saja Rumah Mewah Harga Murah Di Lokasi Strategis,Makassar,Daya,80,78,600000000,158,Small
Lokasi dekat Unhas,Makassar,Tamalanrea,75,72,715000000,147,Small
Tallasa city makassar,Makassar,Biringkanaya,38,96,699000000,134,Small
Rumah taman pertama di makassar,Makassar,Tamangapa,65,80,625000000,145,Small
RUMAH DLM KOTA,Makassar,Lariang Bangi,360,324,3800000000,684,Large
Rumah mewah toddopuli,Makassar,Panakkukang,97,100,956000000,197,Medium
Rumah dekat hertasning makassar,Makassar,Rappocini,110,60,900000000,170,Medium
Rumah Ready tamangapa makassar,Makassar,Tamangapa,40,72,432000000,112,Small
RUMAH DALAM KOTA MAKASSAR,Makassar,Maricaya Baru,70,150,1000000000,220,Small
RUMAH SIAP HUNI DI TENGAH KOTA,Makassar,Maloku,430,143,5500000000,573,Large
RUMAH DLM KOTA MAKASSAR,Makassar,Mangasa,230,630,5500000000,860,Large
GOLDEN AVANUE  CITRALAND CITY LOSARI  CPI,Makassar,Losari,123,126,3565000000,249,Medium
Perumahan Bebas Banjir,Makassar,,38,90,530000000,128,Small
APARTEMEN 31 suite PUSAT KOTA MAKASSAR,Makassar,,60,90,2100000000,150,Small
Rumah Lokasi Barombong MAKASSAR bebas Banjir,Makassar,Barombong,45,90,345000000,135,Small
Jual cepat rumah di barombong siap huni,Makassar,Barombong,108,135,300000000,243,Medium
PMKS Dijual Rumah Tipe 6060 di Roma Corner View Makassar,Makassar,Panakkukang,60,60,1000000000,120,Small
RUMAH MEWAH DI CITRALAND TALLASA CITY DAERAH TAMALANREA DEKAT TOL DAN BANDARA,Makassar,Tamalanrea,182,180,2677000000,362,Large
Rumah murah sudiang,Makassar,Sudiang Raya,47,78,435000000,125,Small
260 MP Dijual Rumah di Jalan Lanto Dg Pasewang Makassar,Makassar,,330,420,6000000000,750,Large
Dijual Cepat Rumah  2 Lantai di Perumahan 9 Residence,Makassar,Rappocini,105,105,1900000000,210,Medium
Dijual rumah dalam kompleks jalan Monumen Emmy Saelan jalan Skarda,Makassar,Rappocini,70,131,650000000,201,Small
perumahan elegan,Makassar,Balla Parang,31,60,541000000,91,Small
Dijual rumah dalam perumahan di jalan Aroepala Hertasning,Makassar,Rappocini,240,120,2000000000,360,Large
RUMAH DIJUAL HARGA MURAH SIAP HUNI DI TELLO,Makassar,Tello Baru,50,84,460000000,134,Small
Dijual Rumah 2 Lantai Area Tamalanrea,Makassar,Biringkanaya,234,162,3000000000,396,Large
Rumah makasar  Yekti,Makassar,,68,180,3000000000,248,Small
Rumah 2 Lantai di Pusat Kota Makassar,Makassar,,60,91,925000000,151,Small
Rumah pusat kota Makassar,Makassar,Mamajang,80,69,775000000,149,Small
Rumah 2 lantai Hertasning,Makassar,,100,91,850000000,191,Medium
RUMAH CANTIK DEPAN DANAU TANJUNG BUNGA MAKASSAR,Makassar,Rappocini,91,153,2600000000,244,Medium
PMKS Dijual Rumah Tipe 8067 di Veteran Selatan Makassar,Makassar,Maricaya,67,80,875000000,147,Small
296 MP Dijual Rumah di Jalan Anuang Makassar,Makassar,,124,62,950000000,186,Medium
Rumah Mewah Berkelas Harga Murah Kota Makassar,Makassar,Manggala,100,82,825000000,182,Medium
RUMAH DIJUAL MAKASSAR DEKAT MALL PANAKKUKANG  RS HERMINA 2 LANTAI,Makassar,Borong,72,78,385000000,150,Small
Di Kota Makassar Hanya 360jt,Makassar,,36,72,360000000,108,Small
RUMAH SIAP HUNI DAYA MAKASSAR BEBAS BANJIR,Makassar,,49,72,420000000,121,Small
PMKS Dijual Rumah Tipe 7572 di Nusa Jaya Residence Makassar,Makassar,Panakkukang,75,72,789180000,147,Small
256 MP Dijual Rumah di Jalan Andi Mappanyukki Makassar,Makassar,Mariso,590,480,13500000000,1070,Large
Rumah siap Huni Lokasi poros jalan barombong Makassar,Makassar,Barombong,51,90,387000000,141,Small
Dijual rumah aman dan nyaman di jalan malengkeri jl daeng tata makassar,Makassar,Rappocini,98,98,2200000000,196,Medium
Dijual rumah dalam perumahan di jalan goa ria Biringkanaya sudiang Makassar,Makassar,Biringkanaya,100,175,750000000,275,Medium
Rumah ready hertasning,Makassar,,40,78,500000000,118,Small
214 MP Dijual Rumah di Jalan Karunrung Raya 2 Makassar,Makassar,Rappocini,180,150,850000000,330,Large
Jual Rumah Tosca Tree  Citraland Celebes Makassar,Makassar,Rappocini,600,400,8000000000,1000,Large
PMKS Dijual Rumah Tipe 2260 di Mutiara Gading 3 Makassar,Makassar,Daya,22,60,429400000,82,Small
35 Dijual Ruko di Jalan Abdullah Dg Sirua Makassar,Makassar,Panakkukang,580,250,4000000000,830,Large
Rumah siap huni Makassar,Makassar,Tanjung Merdeka,148,144,2500000000,292,Medium
211 MP Dijual rumah di Perumahan IDI Pettarani Makassar,Makassar,Masale,255,299,4800000000,554,Large
Jual Rumah Citraland Rallasa City Makassar Type Riviera,Makassar,Tamalanrea,82,105,1238330000,187,Small
PMKS Dijual Rumah Tipe 69105 di Griya Permata Lestari,Makassar,Biringkanaya,69,105,599000000,174,Small
Rumah minimalis btp bebas banjir ready unit,Makassar,Tamalanrea,50,84,500000000,134,Small
PMKS Dijual Rumah Tipe Trivial di Premier Residence Makassar,Makassar,Maccini Sombala,146,126,2794248574,272,Medium
PMKS Dijual Rumah Tipe 4784 di Gemilang Harvest Residence,Makassar,Biringkanaya,47,84,421000000,131,Small
Rumah murah sudiang,Makassar,Sudiang,40,72,395000000,112,Small
RUMAH PROMO CASH DAERAH PERINTIS 3 DEKAT MALL MTOS TAMALANREA,Makassar,Tamalanrea,36,60,399000000,96,Small
234 MP Dijual Rumah di Perumahan Panakkukang Makassar,Makassar,Panakkukang,180,300,3000000000,480,Large
279 MP Dijual Rumah di Komp Lili Panakkukang Makassar,Makassar,Panakkukang,70,105,1300000000,175,Small
PMKS Dijual Rumah Tipe 6090 di Brista Gemilang Makassar,Makassar,Tamalanrea,60,90,548235000,150,Small
Rumah modern di panaikang,Makassar,,45,78,427000000,123,Small
PMKS Dijual Rumah Tipe 47105 di Megah Country Makassar,Makassar,Tamalanrea,47,105,550000000,152,Small
ARUMAH MURAH,Makassar,Mappala,45,72,490000000,117,Small
Rumah Cantik mewah 3 Lantai lokasi Makassar,Makassar,Manggala,118,78,1016000000,196,Medium
216 MP Dijual Rumah di Castell Premium Type 6090 Makassar,Makassar,Pampang,60,90,700000000,150,Small
241 MP Dijual Rumah di Glora Pajjaiang Sudiang Makassar,Makassar,Biringkanaya,60,84,465000000,144,Small
Rumah Baru Modern Estate Makassar,Makassar,Panakkukang,55,108,750000000,163,Small
RUMAH MEWAH 2 LANTAI DI TODOPULI KOTA MAKASSAR,Makassar,Tamangapa,70,67,650000000,137,Small
Jual Rumah Green Garden Tanjung Bunga Makassar,Makassar,Tanjung Merdeka,55,96,500000000,151,Small
27 MP Dijual Rumah di Balmond Residence Makassar,Makassar,Rappocini,220,176,2500000000,396,Large
Hunian Ekslusif di Pengayoman Makassar,Makassar,Panakkukang,349,162,5950000000,511,Large
Rumah modern di pusat kota Makassar,Makassar,Maricaya,165,246,4831000000,411,Large
25 Dijual Rumah di Kompleks Anggrek Jalan Kuning Makassar,Makassar,Rappocini,250,150,950000000,400,Large
RUMAH MEWAH 3KT DI SUDIANG MAKASSAR,Makassar,Biringkanaya,60,90,460000000,150,Small
Rumah siap huni harga miring,Makassar,Barombong,36,70,300000000,106,Small
Rumah minimalis,Makassar,,120,120,400000000,240,Medium
Rumah makassar best seller di makassar,Makassar,Tamalanrea,38,96,692000000,134,Small
rumah comersil lokasi strategis,Makassar,Tamangapa,54,90,685000000,144,Small
rumah nyaman dan Asri,Makassar,Paccerakkang,50,78,515000000,128,Small
Rumah cantik lokasi sangat strategis di dalam kota Makassar dekat dari mall Pana,Makassar,Rappocini,165,150,1650000000,315,Large
Perumahan Syariah dekat mall Panakukang di kota Makassar,Makassar,Borong,54,84,715000000,138,Small
Vetran Selatan Vetran Galaxy Big Promo Januari Diskon hingga 110 jtaan,Makassar,Banta Bantaeng,80,70,765000000,150,Small
Miliki rumah idaman desain elegan harga terjangkau,Makassar,Tamalanrea,45,78,458000000,123,Small
270MP Dijual Rumah di Jalan Perintis Kemerdekaan Makassar,Makassar,Tamalanrea,300,386,550000000,686,Large
DIJUAL RUMAH DIKOMPLEKS MAWAR PANAKUKANG MAKASSAR,Makassar,Masale,300,184,1700000000,484,Large
Rumah Dp 19 juta tamangapa,Makassar,Tamangapa,40,72,432000000,112,Small
26 MP Dijual Rumah di Palada Residence Makassar,Makassar,Paccerakkang,60,90,380000000,150,Small
258 MP Dijual Rumah di Jalan Monginsidi Lama Makassar,Makassar,,550,330,15000000000,880,Large
RUMAH SYARIAH MAKASSAR,Makassar,Panakkukang,70,67,575000000,137,Small
RUMAH SIAP HUNI DI SUDIANG PROMO CASH 418JTT,Makassar,Sudiang,54,91,418000000,145,Small
Rumah murah grand Sulawesi antang,Makassar,Antang,40,72,350000000,112,Small
Rumah siap huni lokasi strategis Barombong Makassar,Makassar,Barombong,43,78,387000000,121,Small
HALMIN RESIDENCE Hertasning baru,Makassar,Rappocini,70,84,1180000000,154,Small
PMKS Dijual Rumah Tipe Dario di Mansion Tanjung Bunga,Makassar,Tamalate,150,126,2958637678,276,Medium
Rumah Siap Huni Daya,Makassar,Biringkanaya,49,72,420000000,121,Small
Di Jual Rumah Murah Di perintis kemerdekaan dekat kampus Unhas,Makassar,Tamalanrea,36,60,388000000,96,Small
PMKS Dijual Rumah Tipe 4072 di Cluster Pelangi Makassar,Makassar,Tamalanrea,40,72,456000000,112,Small
PMKS Dijual Rumah Tipe 3872 di New Rosemary Green River View,Makassar,Tamalate,38,72,461785000,110,Small
Rumah cantik cicilan murah,Makassar,,30,55,355000000,85,Small
Rumah siap huni di minasa upa,Makassar,Rappocini,105,105,675000000,210,Medium
2109 MP Dijual Rumah di Jalan Bougenville Makassar,Makassar,Panakkukang,330,300,4500000000,630,Large
Rumah 3 Kamar   Dekat Kampus Di Jalan Alauddin Makassar,Makassar,Mangasa,40,98,1000000000,138,Small
249 MP Dijual Rumah di Jalan Raya Pendidikan Makassar,Makassar,Rappocini,110,170,2500000000,280,Medium
257 MP Dijual Rumah di Jalan Andi Mappanyukki Makassar,Makassar,Mariso,660,450,14500000000,1110,Large
PMKS Dijual Rumah Tipe 3160 di Cluster Utopia Tallasa City,Makassar,Tamalanrea,31,60,535000000,91,Small
RUMAH 2 LANTAI TENGAH KOTA 4 KAMAR LOKASI VETERAN SELATAN MAKASSAR,Makassar,Mamajang Dalam,80,77,875000000,157,Small
PMKS Dijual Rumah Tipe 4072 di Laqava Land  Makassar,Makassar,Biringkanaya,40,72,423000000,112,Small
PMKS Dijual Rumah Tipe 5078 di Brista Gemilang Makassar,Makassar,Tamalanrea,50,78,458676000,128,Small
Perumahab elit mewah dekat pantai losari dan rs siloam,Makassar,,294,240,3400000000,534,Large
DP Dibayarkan Developer Hanya 400jtaan,Makassar,Daya,30,60,482300000,90,Small
Perumahan AlFath Residence,Makassar,Bonto Biraeng,30,50,258000000,80,Small
PERUMAHAN MEWAH DI HERTASNING BARU,Makassar,Rappocini,98,135,2300000000,233,Medium
rumah sisa 1unit,Makassar,Mangasa,45,78,520000000,123,Small
268 MP Dijual Rumah di Jalan Emmy Saelan III C Makassar,Makassar,,180,300,2800000000,480,Large
272 MP Dijual Rumah di Golden Park Panakukkang Makassar,Makassar,Panakkukang,160,120,1650000000,280,Large
Griya Harapan Pampang Makassar,Makassar,Pampang,50,78,595000000,128,Small
THE MUTIARA PETTARANI,Makassar,Maccini,221,91,3750000000,312,Large
JUAL RUMAH SIAP HUNI DEPAN SMA 10 MAKASSAR,Makassar,Tamangapa,45,78,455000000,123,Small
Rumah 10 menit Bandara Internasional Sultan Hasanuddin Akses  Tol Parangloe,Makassar,Tamalanrea,38,72,507300000,110,Small
TOWN HOUSE PREMIUM DI PUSAT KOTA MAKASSAR,Makassar,Manggala,125,98,123000000,223,Medium
PGW Dijual Rumah Tipe 3672 di Perumahan Tanjung Permai Gowa,Makassar,Barombong,36,72,156500000,108,Small
Rumah 2 lantai dekat ke bandara makassar,Makassar,Sudiang,100,112,800000000,212,Medium
RUMAH READY STOK DI TALLASA CITY DEKAT AKSES TOL DAN PERINTIS KEMERDEKAAN,Makassar,Tamalanrea,49,96,772000000,145,Small
Dijual Rumah Cantik 1 12 Lantai Daerah Toddopuli XV Makassar,Makassar,Manggala,120,90,750000000,210,Medium
Rumah  citrland 700 jutaaan,Makassar,Tamalanrea,36,72,717000000,108,Small
Di Jual Rumah Mewah Strategis Poros Asrama Haji  Makassar,Makassar,Sudiang Raya,57,78,450000000,135,Small
Dijual rumah dalam perumahan dijalan borong raya jalan batua raya,Makassar,Batua,72,90,550000000,162,Small
Rumah Makassar Best Seller,Makassar,Biringkanaya,36,72,475700000,108,Small
Rumah makassar mewah di kota mandiri,Makassar,Tamalanrea,267,300,5333000000,567,Large
THE TOPAZ RESIDENCE  SUMMARECON MUTIARA MAKASSAR,Makassar,Biringkanaya,55,64,750000000,119,Small
Wilayah Sangat Strategis Di Poros Jalan Raya Sangat Dekat Dengan Pasar Tradisional T,Makassar,Paropo,221,221,2500000000,442,Large
RUMAH DIJUAL DITANJUNG BUNGA PERUMAHAN BLOSSOM,Makassar,Tamalate,70,126,1000000000,196,Small
214 Dijual Rumah di Jalan Dg Tata 1 Makassar,Makassar,Tamalate,110,100,700000000,210,Medium
RUMAH 2 LANTAI DEKAT JL POROS  MAKASSAR SUDIANG DEKAT GOR,Makassar,,36,112,800000000,148,Small
Golden Galaxi Inn Panakukkang Paling Strategis Di Makassar,Makassar,Manggala,100,96,705000000,196,Medium
PMKS Dijual Rumah Tipe 6072 di Nusa Jaya Residence Makassar,Makassar,Panakkukang,60,72,589920000,132,Small
217 Dijual Rumah Kosan di Kompleks IDI Panakkukang Makassar,Makassar,Panakkukang,800,565,3800000000,1365,Large
255 MP Dijual Rumah di Perumahan Permata Hijau permai Makassar,Makassar,Rappocini,150,250,1600000000,400,Medium
Rumah baru Hoo Citraland,Surabaya,Citraland,170,154,2400000000,324,Large
Rumah Forest Mansion Full Furnist,Surabaya,Lakarsantri,300,150,5000000000,450,Large
RUMAH PAKUWON INDAH EUROPEAN CLASSIC SANGAT MEWAH dekat mall pusat bisnis dan,Surabaya,Pakuwon,2400,1720,75000000000,4120,Large
Perumahan SHM 2 Lantai Ready Unit 370 Jutaan Dekat Kampus UPN,Surabaya,Gunung Anyar Tambak,43,28,379500000,71,Small
Rumah gunung anyar dekat bandara dan Galaxy Mall,Surabaya,Gunung Anyar,70,58,895000000,128,Small
Dijual Rumah Oakwood Citraland Surabaya,Surabaya,Citraland,143,120,2850000000,263,Medium
Perumahan Murah 2 Lantai 260 Jutaan Surabaya Timur,Surabaya,Gunung Anyar Tambak,28,21,269000000,49,Small
Dijual Rumah Mewah Rungkut Asri stok Terbatas,Surabaya,Rungkut,68,50,1195000000,118,Small
Dijual Rumah NorthwestLake Citraland,Surabaya,Citraland,69,72,1000000000,141,Small
Rumah Mewah Murah 0 Jalan Raya Wiyung 192  m,Surabaya,Wiyung,102,192,3272000000,294,Medium
Termurah American Minimalis 2 Lt Super Terawat Graha Family Favorit,Surabaya,Wiyung,550,345,14000000000,895,Large
Rungkut Asri 2 Lantai Harga Nego Sampai Deal,Surabaya,Rungkut,300,325,3750000000,625,Large
RUMAH BUKIT GOLF CITRALAND KONSEP VILLA BALI dekat JLLB clubhouse komersial,Surabaya,Citraland,780,1000,26750000000,1780,Large
RUMAH CITRALAND BARU GRES MEWAH GOLF VIEW ada SWIMMING POOL dekat clubhouseJLLB,Surabaya,Citraland,1500,944,42000000000,2444,Large
Rumah Full Furnished Royal Residence Modern Minimalis,Surabaya,Wiyung,450,375,6500000000,825,Large
RUMAH DARMO HARAPAN HOOK dekat Hokky swimming fitness pusat bisnis Surabaya,Surabaya,Sukomanunggal,600,449,7000000000,1049,Large
RUMAH DARMO BARU TIMUR dekat lapangan tennis tol pusat bisnis dan komersial,Surabaya,Sukomanunggal,300,240,3800000000,540,Large
RUMAH DARMO HARAPAN BARU RENOVASI dekat Superindo Hokky swimming fitness cente,Surabaya,Sukomanunggal,230,800,9500000000,1030,Large
RUMAH ISEN INTERNATIONAL LIVING by Intiland SWIMMING POOL dekat Hokky clubhouse,Surabaya,Sukomanunggal,350,375,11500000000,725,Large
RUMAH GRAHA FAMILY BARU GRES dekat clubhouse Loop tol pusat bisnis,Surabaya,Graha,550,345,15000000000,895,Large
RUMAH BUKIT GOLF INTERNASIONAL CITRALAND BARU GRES MEWAH dekat JLLB clubhouse,Surabaya,Citraland,500,300,9500000000,800,Large
RUMAH VILLA BUKIT REGENCY 3 PAKUWON INDAH BARU GRES dekat mall pusat bisnis,Surabaya,Pakuwon,500,300,9350000000,800,Large
Rumah mewah perumahan Rungkut DP minim,Surabaya,Medokan Ayu,75,90,735000000,165,Small
RUMAH MEWAH SIAP HUNI DI MOSSEL BAY  GRAND ISLAND PAKUWON CITY HANYA 48 M,Surabaya,Mulyorejo,203,160,4800000000,363,Large
RUMAH DARMO HARAPAN dekat Hokky swimming fitness center pusat bisnis Surabaya,Surabaya,Sukomanunggal,400,664,10000000000,1064,Large
Rumah Baru,Surabaya,Gunung Anyar Tambak,150,105,850000000,255,Medium
RUMAH PAKUWON INDAH MEWAH BARU RENOVASI TOTAL ada SWIMMING POOL dekat mall pusa,Surabaya,Pakuwon,650,450,18000000000,1100,Large
RUMAH CITRALAND BARU GRES MEWAH ada SWIMMING POOL dekat danau Merlion Gwalk,Surabaya,Citraland,1200,670,22000000000,1870,Large
Rumah Ready Stok Dp 0 ,Surabaya,,72,72,397000000,144,Small
Dijual Rumah Royal Residence Cluster Greenwich,Surabaya,Sumur Welut,200,160,4200000000,360,Large
Graha Famili surabaya barat mewah minimalis dkt unesa pakuwon wiyung,Surabaya,Graha,1300,975,40000000000,2275,Large
KARANG ASEM RUMAH BARU 2 LANTApI 11an,Surabaya,Kenjeran,135,90,1100000000,225,Medium
Rumah cantik 2 lantai Medokan Rungkut,Surabaya,Rungkut,60,42,550000000,102,Small
Rumah Griya Ani nol jalan Raya  Medokan Rungkut buat usaha,Surabaya,Rungkut,70,61,800000000,131,Small
Rumah murah bisa KPR rungkut,Surabaya,Medokan Ayu,55,48,390000000,103,Small
Rumah mewah 2 lantai Rungkut DP minim pol,Surabaya,Rungkut,75,86,770000000,161,Small
Di Jamin Termurah Rumah 25 Lantai Siap Huni Di Gunung Anyar Surabaya,Surabaya,Gunung Anyar Tambak,56,32,499000000,88,Small
Rumah mewah 2 lantai  Griya Ani,Surabaya,Medokan Ayu,70,45,660000000,115,Small
Rumah Griya Ani Cluster 10m jalan raya,Surabaya,Medokan Ayu,40,45,530000000,85,Small
Rumah cantik  perumahan BME Keputih,Surabaya,Sukolilo,60,42,750000000,102,Small
Rumah mewah Wonorejo selatan,Surabaya,Rungkut,45,100,725000000,145,Small
Rumah ciamik Griya Ani Medokan Deket jalan raya DP minim,Surabaya,Rungkut,60,75,710000000,135,Small
MURAH Rumah 2 Lantai Siap Huni Bronggalan Dekat MERR,Surabaya,Gubeng,99,105,850000000,204,Medium
rumah mewah di tengah kota sidoarjo,Surabaya,Warugunung,88,82,921000000,170,Small
Rumah baru dekat toll waru dan terminal bungurasih,Surabaya,Ketintang,36,65,350000000,101,Small
Jual Murah Rumah Klampis Semolo Barat Cocok Untuk Investor Dekat Galaxy Mall,Surabaya,Klampis Ngasem,250,175,1650000000,425,Large
Rumah Perumahan Murah Angsuran 900rb an,Surabaya,Sukolilo,30,60,150500000,90,Small
Rumah Ready  Rungkut Surabaya,Surabaya,Rungkut,96,75,1295000000,171,Medium
Rumah Ready Siap Huni Gayungsari Surabaya,Surabaya,Gayungan,200,136,2250000000,336,Large
Dijual rumah luas di Medokan Ayu Surabaya,Surabaya,Medokan Ayu,40,100,575000000,140,Small
RUMAH SURABAYA BARAT Lakarsantri,Surabaya,Lakarsantri,120,135,990000000,255,Medium
Jangan beli rumah 2 lantai di medokan surabaya faktanya 200 jtan,Surabaya,Gunung Anyar,27,20,269000000,47,Small
DijualRumah 2 Lantai Grand Harvest Belvoir Surabaya,Surabaya,Kebraon,67,102,1350000000,169,Small
Dijual Rumah Nirwana Eksekutif,Surabaya,Rungkut,147,95,1525000000,242,Medium
Rumah Siwalankerto 200m dr frontage Ahmad yani,Surabaya,Siwalankerto,70,40,750000000,110,Small
Dijual Rumah Mulyosari Surabaya,Surabaya,Mulyorejo,160,190,1700000000,350,Large
Hunian Promo Akhir Tahun Diskon 100Jt,Surabaya,Gayungan,42,75,240000000,117,Small
DIJUAL RUMAH MINIMALIS MEWAH PAKUWON CITY Surabaya,Surabaya,Mulyorejo,620,450,15500000000,1070,Large
Rumah 2 LT Siap Huni Lokasi Istimewa Hoek pojokan antara BB IV dan BB VII,Surabaya,Baratajaya,230,252,2400000000,482,Large
BABATAN PRATAMA MINIMALIST HOOK FULL FURNISH,Surabaya,Wiyung,220,162,2788000000,382,Large
DIJUAL Rumah Buagus Siap Huni Tinggal Bawa Koper Graha Family,Surabaya,Graha,300,249,7300000000,549,Large
Dijual Rumah Special Sby Barat Minimalis Tropis Hook Furnished,Surabaya,Wiyung,210,272,4600000000,482,Large
rumah murah 2 lantai surabaya sidoarjo,Surabaya,,88,84,900000000,172,Small
Dijual Cepat Rumah Mewah Wisata Bukit Mas Harga Terjangkau Kondisi Siap Huni,Surabaya,Lakarsantri,300,200,2999999999,500,Large
RUMAH KAVLING MURAH  SURABAYA BARAT BENOWO,Surabaya,Benowo,55,55,240000000,110,Small
FOR SALE RUMAH GRAHA FAMILY,Surabaya,Dukuh Pakis,272,255,7500000000,527,Large
Rumah Baru 2 Lantai Berkualitas,Surabaya,Pakal,80,50,350000000,130,Small
DIJUAL TANAH DAN RUMAH DI MULYOREJO BONUS TOKO,Surabaya,Mulyorejo,120,432,5200000000,552,Medium
Rumah Baru Dekat SMAN 12 Surabaya,Surabaya,Sememi,36,45,290000000,81,Small
DIJUAL RUMAH BARU GRAND KUWUKAN SURABAYA BARAT BLOK B5,Surabaya,Lontar,70,71,800000000,141,Small
Dijual Cepat Rumah 2 Lt Cluster Taman Mutiara Pakuwon City,Surabaya,Pakuwon,135,112,3150000000,247,Medium
Jual Rumah Baru Gress  Graha Natura,Surabaya,,149,144,2900000000,293,Medium
RUMAH CITRALAND BGI FULLY FURNISHED,Surabaya,Citraland,750,603,21500000000,1353,Large
Dijual Rumah 2 Lt Cluster Zimbali Kosta Pakuwon City,Surabaya,Pakuwon,84,72,2100000000,156,Small
RUMAH CITRALAND RAYA FULLERTON PLACE FULLY FURNISHED,Surabaya,Citraland,600,450,16000000000,1050,Large
rumah mewah Surabaya dijual Murah Di perumahan masjid agung residence,Surabaya,Menanggal,285,173,4500000000,458,Large
Dijual Rumah Satelit Surabaya,Surabaya,,815,700,15000000000,1515,Large
Dijual  DISEWAKAN RUMAH Villa Valencia Pakuwon,Surabaya,Pakuwon,250,300,5500000000,550,Large
Dijual Rumah Grand Harvest Surabaya,Surabaya,Karangpilang,49,108,1500000000,157,Small
Dijual Rumah Villa Royal Pakuwon City,Surabaya,Mulyorejo,550,450,15000000000,1000,Large
Dijual Rumah Pondok Nirwana Sidoarjo,Surabaya,Rungkut,280,200,4250000000,480,Large
Dijual Rumah Pantai Mentari Surabaya,Surabaya,,225,180,3500000000,405,Large
Rumah di Pakuwon City Taman Mutiara Surabaya Murah Dijual,Surabaya,Pakuwon,90,90,1899000000,180,Small
RUMAH GOLF VIEW TERCIAMIK GRAHA FAMILY,Surabaya,Graha,522,930,35000000000,1452,Large
Dijual Rumah 2 Lt Cluster Taman Mutiara Pakuwon City,Surabaya,Pakuwon,150,90,2650000000,240,Medium
Dijual Rumah Darmo Permai Timur,Surabaya,Dukuh Pakis,181,193,2950000000,374,Large
Dijual Rumah Jalan Nginden Surabaya,Surabaya,,300,220,3600000000,520,Large
Dijual Rumah Graha Family,Surabaya,,450,322,7500000000,772,Large
Rumah Baru Gress Full Furnished Graha Natura,Surabaya,,150,144,3300000000,294,Medium
Benowo Surabaya  Rumah Siap Huni Murah 90 m SHM Dreaming Land Sememi,Surabaya,Sememi,60,90,655000000,150,Small
Rumah Siap Huni West Wood Village Pakuwon City Surabaya,Surabaya,Pakuwon,250,200,3600000000,450,Large
Dijual Rumah North West Hill,Surabaya,,80,72,1700000000,152,Small
Graha Natura blok B  main road cluster  2 Lantai,Surabaya,,284,320,7000000000,604,Large
Dijual rumah murah surabaya,Surabaya,,120,450,6000000000,570,Medium
rumah second luas dan Large di jual murah di perumahan Kebraon indah permai,Surabaya,Wiyung,150,130,1350000000,280,Medium
Rumah Baru Citraland Puri Widya Kencana dekat Rafless Fullerton,Surabaya,Citraland,400,253,6500000000,653,Large
RUMAH MEWAH DI SURABAYA,Surabaya,,350,420,8000000000,770,Large
RUMAH MEWAH DI CITRALAN SURABAYA BARAT TURUN 1 MILYARD,Surabaya,,330,306,5800000000,636,Large
Harga di Bawah Pasaran Dijual Rumah Di Jalan Raya MERR Lokasi Strategis,Surabaya,Rungkut,300,600,14000000000,900,Large
Rumah Murah 2 jutaan,Surabaya,Tambak Osowilangun,40,72,400000000,112,Small
SIMO SIDOMULYO SURABAYA,Surabaya,Petemon,245,253,2001000000,498,Large
Dijual Rumah Usaha,Surabaya,,386,229,5500000000,615,Large
Rumah Baru Minimalis Modern,Surabaya,Medokan Ayu,32,50,490000000,82,Small
FOR SALE  GRAHA FAMILI SURABAYAGOLF VIEW PRIVATE POOL,Surabaya,Graha,2500,1250,65000000000,3750,Large
Rumah 2 Lantai Dukuh Kupang Lokasi Dekat Indomart  Kampus Uwk,Surabaya,Dukuh Kupang,175,175,2800000000,350,Large
Rumah Northwest Citraland dekat pasar modern,Surabaya,Citraland,46,72,755000000,118,Small
For Sale Rumah Mewah Graha Family,Surabaya,Dukuh Pakis,600,322,10000000000,922,Large
Dijual Rumah Citraland Emerald mansion tipe Canna Surabaya,Surabaya,Citraland,182,180,4239000000,362,Large
taman jivva sidoarjo rumah 2 lantai tengah kota,Surabaya,,88,82,1166000000,170,Small
Dijual Rumah Baru Citraland Crystal Golf Carnelian Surabaya,Surabaya,Citraland,98,75,2226000000,173,Medium
EASTWOOD CITRALAND SURABAYA,Surabaya,Citraland,120,171,2250000000,291,Medium
Dijual Rumah Untuk Usaha dan Tempat Tinggal,Surabaya,,386,229,5500000000,615,Large
TERMURAH ALAM GALAXY LONTAR DEKAT CITRALAND PAKUWON GRAHA,Surabaya,Sambikerep,165,162,2500000000,327,Large
Rumah Citraland langsung masuk Fully Furnished,Surabaya,Citraland,150,105,1974999999,255,Medium
Jual Rumah Nginden Surabaya,Surabaya,Nginden,120,160,2300000000,280,Medium
Rumah Wisata Bukit Mas 2 Grand Palais,Surabaya,Wiyung,319,240,5000000000,559,Large
Gubeng Surabaya  Rumah Murah Minimalis 2Lt SHM Kalibokor Pucangsewu,Surabaya,Pucangsewu,40,32,590000000,72,Small
RUMAH MURAH SURABAYA TIMUR,Surabaya,,105,162,1400000000,267,Medium
RUMAH KOS 2 LANTAI MURAH CUMA 1M,Surabaya,,240,120,1200000000,360,Large
Murah  Rumah di North West Park Citraland,Surabaya,Citraland,36,72,795000000,108,Small
Rumah harga murah di Grand Pakuwon,Surabaya,Pakuwon,78,72,1250000000,150,Small
Hunian Dilokasi Sangat Strategis Prospek Bagus Dekat Rencana OERR,Surabaya,Rungkut,42,75,199000000,117,Small
Dijual jemur gayungan AYani Surabaya,Surabaya,Ketintang,171,291,1500000000,462,Large
Rumah Siap Huni 1 Lantai Jln Jambangan VII Surabaya,Surabaya,Jambangan,80,103,875000000,183,Small
Rumah baru gress di Bronggalan,Surabaya,Kalijudan,90,75,850000000,165,Small
Rumah Bagus Baru Gress di Greenwich Siap Huni Surabaya,Surabaya,Wiyung,230,188,3250000000,418,Large
RUMAH SUPER MEWAH EROPA KLASIK FULL FURNISHED TERMURAH DI GAYUNGSARI SURABAYA SELATAN,Surabaya,Gayungan,1000,700,15000000000,1700,Large
Asem Rowo Surabaya  Rumah Siap Huni 84 m2 SHM Dekat St Pasar Turi,Surabaya,Asem Rowo,84,84,700000000,168,Small
RUMAH CITRALAND MEWAH HOOK,Surabaya,Citraland,550,440,10000000000,990,Large
Rumah Palm Oasis Sememi Surabaya barat Lokasi strategis,Surabaya,,80,84,1300000000,164,Small
Gununganyar Surabaya  Rumah Murah 100 m2 SHM Dekat UPN Rungkut MERR,Surabaya,Gunung Anyar,100,100,500000000,200,Medium
JARANG ADA RUMAH HITUNG HARGA TANAH SAJA DI PUSAT KOTA JL SUMATERA,Surabaya,,318,318,7490000000,636,Large
Benowo Surabaya Barat  Rumah Baru Modern 2Lt Murah di Tengger Raya,Surabaya,Kandangan,80,40,395000000,120,Small
Jual Rumah 2 Lantai Siap Huni SHM KT 5 KM 3 Kali Kepiting Jaya Surabaya,Surabaya,Tambaksari,150,170,1950000000,320,Medium
Rumah Kutisari Selatan Selangkah Ke Raya Jemursari Tenggilis UK Petra Sby,Surabaya,Kutisari,75,47,970000000,122,Small
Rungkut Sby  Rumah Baru Gress 2Lt 90 m2 SHM di Rungkut Menanggal,Surabaya,Rungkut Menanggal,120,90,1400000000,210,Medium
Citraland Siap Huni dekat Gwalk HANYA 2M NEGO,Surabaya,Citraland,100,128,2000000000,228,Medium
RUMAH MINIMALIS MEWAH MURAH 2 LANTAI DI SURABAYA,Surabaya,,205,250,3950000000,455,Large
Rumah Klasik Belanda di Begawan Serayu Surabaya,Surabaya,Wonokromo,500,1225,38000000000,1725,Large
RUMAH MURAH DENGAN KOLAM RENANG DI SIDOSERMO PDK,Surabaya,,400,314,3990000000,714,Large
RUMAH COCOK UNTUK KOMERSIL STRATEGIS DEKAT KAMPUS UPN,Surabaya,,120,390,4750000000,510,Medium
RUMAH MINIMALIS HOT FOR SALE BU PREMIUM QUALITY,Surabaya,,113,114,3200000000,227,Medium
Jual Rumah 1 Lt New Royal 2 Gunung Anyar Surabaya,Surabaya,Gunung Anyar,37,80,700000000,117,Small
Gununganyar Surabaya  Rumah Murah 55 m2 SHM di Perum Wiguna Timur,Surabaya,Gunung Anyar,36,55,599000000,91,Small
Jual Rumah Baru 2 Lantai KT 3 KM 3 Perum Taman Intan Nginden Surabaya,Surabaya,Nginden,144,108,1850000000,252,Medium
RUMAH STANDARD RUNGKUT ASRI TIMUR MURAH HITUNG TANAH BEAA067,Surabaya,Rungkut,140,200,1550000000,340,Medium
Rumah murah Ready Stok Siap Huni,Surabaya,Pakis,50,78,572000000,128,Small
Rumah Promo Beli 2 Gratis 1,Surabaya,Darmo Permai,42,77,349000000,119,Small
Gununganyar Surabaya  Rumah Murah 90 m2 di Perum Wiguna Selatan,Surabaya,Gunung Anyar,90,90,750000000,180,Small
Jual Rumah Baru 1 Lantai KT 2 KM 1 SHM New Royal Gunung Anyar Surabaya,Surabaya,Gunung Anyar,42,80,700000000,122,Small
MURAH POL DIJAMIN TERMURAH HARGA TURUN BANYAK,Surabaya,,480,480,19500000000,960,Large
Rumah Rasa Villa Cicilan 1 Jutaan,Surabaya,Lakarsantri,29,60,195000000,89,Small
Dijual Rumah Grees Mulyosari Baru Siap Huni Sutorejo Manyar,Surabaya,Mulyosari,160,92,1700000000,252,Large
Rungkut Sby  Rumah Murah 100 m2 SHM di Wonorejo Selatan Dekat MERR,Surabaya,Wonorejo,100,10,785000000,110,Medium
dijual rumah baru gres 2 lantai di bukit palma citraland surabaya,Surabaya,Citraland,170,154,2400000000,324,Large
RUMAH MURAH HITUNG HARGA TANAH SAJA DI RAYA BABATAN PRATAMA,Surabaya,,357,357,3190000000,714,Large
Dijual Rumah Wisata Bukit Mas 2 Wiyung Boulevard Luar Cluster,Surabaya,Wiyung,400,240,6900000000,640,Large
Rumah Gress New Kutisari Selangkah Ke Raya Jemursari Surabaya,Surabaya,Kutisari,66,56,700000000,122,Small
Rumah Bulu jaya Darmo Lontar Pakuwo,Surabaya,Lontar,46,46,490000000,92,Small
RUMAH  KANTOR KOMERSIAL AREA DI JL GAYUNGSARI,Surabaya,,650,423,5790000000,1073,Large
RUMAH MINIMALIS MURAH CUMA 1M DI CITRALAND SURABAYA HARGA BU,Surabaya,,110,150,1400000000,260,Medium
JUAL CEPAT MAU SEGERA PINDAH Citraland North Emerald Mansion ada Kolam,Surabaya,Citraland,325,252,5300000000,577,Large
Di Jual Rumah Mewah Siap Huni area semampir surabaya,Surabaya,Semampir,140,72,1400000000,212,Medium
Rumah Baru Siap Huni Shm Gunung Anyar Dekat Wiguna Surabaya,Surabaya,Gunung Anyar,50,90,675000000,140,Small
Diskon Awal Tahun  Hunian Type 4275 Sangat Ideal Dan Strategis Promo,Surabaya,Semampir,42,75,210000000,117,Small
Dijual Rumah Promo Harga Di Bawah 200 juta,Surabaya,Ketintang,36,75,199000000,111,Small
Rumah Baru Mulyosari dekat pakuwon city,Surabaya,Mulyosari,200,120,2100000000,320,Large
RUMAH KOST EKSKLUSIF 35 KAMAR  KMR MANDI DALAM FULL RENOVASI DIJUAL MURAH DI SIWALAN,Surabaya,Wonocolo,1200,611,6000000000,1811,Large
Dijual Rumah 2 Lantai Di Satelit Utara Surabaya,Surabaya,,200,240,2600000000,440,Large
Dijual Rumah Grees Sutorejo Timur Siap Huni Mulyosari Pakuwon City,Surabaya,Dukuh Sutorejo,200,79,1950000000,279,Large
Tambaksari Sby  Rumah Murah 2Lt SHM di Lebak Jaya Dekat Kenjeran,Surabaya,Gading,90,45,510000000,135,Small
Rumah Semi Furnish Citraland Utama dekat dengan area GOLF Harga masih,Surabaya,Citraland,350,300,5350000000,650,Large
Rumah siap pakai Citraland fully furnished,Surabaya,Citraland,225,160,3948000000,385,Large
Rumah Mewah Di Kota Sidoarjo 2 Kamar tidur 1 kamar kamar mandi,Surabaya,Krembangan,58,108,635000000,166,Small
Rumah Modern Didalam Kawasan Perumahan Large Harga Bersahabat,Surabaya,Jambangan,45,75,345000000,120,Small
Dijual Rumah Baru Gresss  di Citraland Utama  Surabaya Barat,Surabaya,Citraland,158,150,3300000000,308,Large
Rumah New Gress Citraland Cluster Woodland,Surabaya,Citraland,300,210,4800000000,510,Large
Graha Natura ada swimming pool,Surabaya,,281,300,8799000000,581,Large
Perumahan Green Mansion Dkt Sedati  Waru  Sidoarjo Jawa Timur,Surabaya,Mulyorejo,40,72,349999999,112,Small
Rumah di Wonorejo belakang STIKOM,Surabaya,Wonorejo,180,96,1250000000,276,Large
Rumah di daerah Darmo Baru Barat,Surabaya,Darmo,180,180,1500000000,360,Large
Rumah Siap Huni Manyar Kertoarjo dekat dengan Pusat Kota,Surabaya,Manyar Kerto Adi,3,467,10000000000,470,Small
Bawah harga  Rumah di Bukit Darmo Golf,Surabaya,,2000,1527,68000000000,3527,Large
Dijual Rumah Modern Minimalis  Full Furnish GALAXY BUMI PERMAI ARAYA,Surabaya,Sukolilo,326,375,10000000000,701,Large
Dijual Rumah Hook Siap Huni Minimalis Bonus Furniture Royal Residence,Surabaya,,190,262,3800000000,452,Large
Dijual Rumah New Split Level Wisata Bukit Mas New Split Level Modern Design,Surabaya,,196,110,2750000000,306,Large
Dijual Murah Rumah Siap Huni Wiguna Regency  Surabaya Timur,Surabaya,Gunung Anyar,210,120,1600000000,330,Large
Dijual Rumah Second Wisata Bukit Mas 2 Luxemburg,Surabaya,,160,160,2800000000,320,Large
Dijual Rumah Baru Manyar Tirtoyoso Selatan Colonial Modern Style Surabaya Timur,Surabaya,,220,194,4500000000,414,Large
RUMAH DI JUAL DI RUNGKUT SURABAYA,Surabaya,Rungkut,139,84,2166000000,223,Medium
Rumah Siap Huni Gunung Anyar Surabaya,Surabaya,Gunung Anyar,100,50,650000000,150,Medium
Dijual Rumah Citraland Surabaya cluster Puri Widya Kencana,Surabaya,Citraland,380,280,5200000000,660,Large
RUMAH MINIMALIS 2 LANTAI DI SURABAYA NEGO TIPIS,Surabaya,,100,54,1200000000,154,Medium
Rungkut Surabaya  Rumah Baru Renovasi 90 m SHM Medokan Ayu MERR UPN,Surabaya,Medokan Ayu,90,90,575000000,180,Small
Rumah Baru Siap Huni 2 Lantai Shm KT 3 KM 2 Dekat Wiguna Gunung Anyar Surabaya,Surabaya,Gunung Anyar,60,57,695000000,117,Small
Kredit Rumah DP Bisa Dicicil di Juanda,Surabaya,Pabean Cantikan,45,78,485000000,123,Small
Dijual rumah WBM 2  New Gress 2 lantai,Surabaya,Wiyung,76,60,1700000000,136,Small
RUMAH SIAP HUNI CITRALAND UTAMA DEKAT GWALK,Surabaya,Citraland,200,222,3500000000,422,Large
Rumah mewah private kolam renang Citraland Wp,Surabaya,Citraland,500,300,6000000000,800,Large
Pakal Surabaya Barat  Rumah Mezanine Murah 40 m2 di Beji Pdam,Surabaya,Pakal,40,40,295000000,80,Small
Gununganyar Surabaya  Rumah Baru Minimalis Murah 2Lt 206m MERR UPN,Surabaya,Gunung Anyar Tambak,27,20,264099000,47,Small
Rumah Dijual Siap Huni Di Babatan Mukti Surabaya,Surabaya,,153,153,1800000000,306,Large
Gununganyar Surabaya  Rumah Baru Minimalis Murah 2Lt MERR UPN Tol,Surabaya,Gunung Anyar Tambak,43,28,417450000,71,Small
Siap huni  rumah di Graha Family,Surabaya,Graha,273,225,4750000000,498,Large
Rumah Citraland Bukit Palma Minimalis Oke Siap Huni Surabaya,Surabaya,Citraland,180,150,2400000000,330,Large
RUMAH BARU GRESS Mewah Graha Famili,Surabaya,Pradakalikendal,550,345,16000000000,895,Large
Rumah Citraland Utama MURAH BANGETT,Surabaya,Citraland,400,288,4490000000,688,Large
Rumah Baru Citraland Utama dekat Gwalk,Surabaya,Citraland,550,440,9800000000,990,Large
Rungkut Surabaya  Rumah Minimalis 2 Lt Murah SHM di Wonorejo,Surabaya,Wonorejo,55,32,550000000,87,Small
HARGA TURUN JAUH LOKASI STRATEGIS DI KOTA SURABAYA,Surabaya,,153,160,1250000000,313,Large
Jual Cepat PALING MURAH Northwest Lake Ukuran Paling Large View Danau,Surabaya,Citraland,138,135,2350000000,273,Medium
RUMAH TERAWAT SIAP HUNI Citraland Utama dekat Gwalk,Surabaya,Citraland,240,160,3500000000,400,Large
Di Jual Rumah 2 Kamar Tidur 1 Kamar Mandi Di Juanda,Surabaya,Rungkut,36,75,199000000,111,Small
Rumah DP 0 Angsuran 1 Jutaan,Surabaya,Wiyung,29,60,195000000,89,Small
SPESIAL PROMO OKTOBER BIG SALE HANYA 199 JT,Surabaya,Lakarsantri,36,75,199000000,111,Small
MURAH RUMAH LUAS DI SURABAYA,Surabaya,,90,90,870000000,180,Small
RUMAH MURAH SURABAYA TIMUR,Surabaya,,105,162,1400000000,267,Medium
RUMAH FULL FURNISH CITRALAND HANYA 2M AN SAJA,Surabaya,Citraland,95,102,2522000000,197,Medium
JUAL CEPAT PALING MURAH RAYA CITRALAND UTAMA,Surabaya,Citraland,428,308,5500000000,736,Large
Promo Melimpah  Perumahan Dekat Bandara Juanda Berkonsep Modern 325Jt,Surabaya,Jambangan,42,75,325000000,117,Small
Perumahan Modern Idaman Harga Hanya 325 Jt Dekat Rencana OERR,Surabaya,Wiyung,42,72,325000000,114,Small
Perumahan Diskon 40 Jt  Lokasi Bagus Akses Mudah,Surabaya,Gayungan,42,72,355000000,114,Small
Tambaksari Surabaya  Rumah Murah Butuh Renov 80 m2 SHM di Lebak Indah,Surabaya,Tambaksari,80,80,575000000,160,Small
TURUN HARGA BANYAK DIJUAL CEPAT RUMAH BARU GRESS CITRALAND,Surabaya,Citraland,158,135,2800000000,293,Large
RUMAH FULL FURNISH MURAH CITRALAND UTAMA dekat gwalk,Surabaya,Citraland,890,450,15000000000,1340,Large
Dijual Rumah Siap Huni Di Jalan Mojoklangru Lor Surabaya,Surabaya,Gubeng,74,110,1250000000,184,Small
Perumahan Murah Bagus Strategis Prospek Bagus,Surabaya,Nginden,42,75,250000000,117,Small
Jual Rumah Surabaya Pusat Jalan Juwono Halaman Luas Commercial Area Siap Huni,Surabaya,Wonokromo,500,574,14500000000,1074,Large
New minimalis  rumah di Gununganyar Rungkut Modern,Surabaya,Gunung Anyar,55,40,625000000,95,Small
Rumah Baru Gress Lokasi Di Rungkut Siap Bangun,Surabaya,Wonorejo,70,48,699999999,118,Small
Dijual Rumah Royal Residence minimalis 3Man dekat danau,Surabaya,Wiyung,180,128,3100000000,308,Large
Dijual Rumah Baru Pakuwon City Grand Island,Surabaya,Pakuwon,115,72,2300000000,187,Medium
Karangpilang Surabaya  Rumah Pojok 2 Lt 109 m2 SHM di Griya Kebraon,Surabaya,Karangpilang,120,109,1200000000,229,Medium
Rumah Baru Gress Modern Bangunan Istimewa Citraland Utama dekat Gwalk,Surabaya,Citraland,168,128,3100000000,296,Large
DIJUAL RUMAH SIAP HUNI DI Jl Jemursari Timur,Surabaya,Jemursari,311,200,3200000000,511,Large
Perumahan Bagus Hanya 325Jt Akses Mudah Dekat MERR dan Rencana OERR,Surabaya,Jambangan,42,72,325000000,114,Small
Brand New Rumah 2 Lantai Minimalis area Bogangin Kedurus dekat Wiyung  Mastrip,Surabaya,,58,50,650000000,108,Small
Dijual Murah Surabaya Barat Satelit Indah,Surabaya,Sukomanunggal,610,610,6900000000,1220,Large
Harga Diskon Akhir Tahun  Hunian Bagus Modern Kekinian Bebas Banjir,Surabaya,Nginden,45,75,345000000,120,Small
Hunian Nyaman Desain Minimalis Citraland Utama dekat Gwalk BISA NEGO,Surabaya,Citraland,350,300,6500000000,650,Large
Di Jual Sutorejo Prima Selatan,Surabaya,Mulyorejo,210,166,3400000000,376,Large
Rumah Minimalis Baru di Kenjeran Surabaya,Surabaya,Kenjeran,80,80,385000000,160,Small
DIJUAL RUMAH PANDUGO RUNGKUT,Surabaya,Rungkut,70,120,1200000000,190,Small
Strategis Rumah 2 lantai babatan pratama dekat citraland tol wiyung,Surabaya,Wiyung,162,220,2600000000,382,Large
Rumah Murah 2 lantai di Sukodono Sidoarjo,Surabaya,Graha,50,50,285000000,100,Small
Rumah Siap Huni Setro Kedung Cowek Surabaya Utara,Surabaya,Kenjeran,30,16,245000000,46,Small
Rumah Siap Huni Fasilitas Lengkap di Jl Rungkut Asri Tengah Surabaya 0602,Surabaya,Rungkut,350,485,7500000000,835,Large
Tenggilis MejoyoSurabaya  Rumah Siap Huni 2 Lt180m2 SHM Kendangsari,Surabaya,Kendangsari,360,180,3100000000,540,Large
DIJUAL Rumah Mewah MURAH Kertajaya Indah Siap HUNI,Surabaya,Kertajaya,200,240,4399999999,440,Large
Alana Cemandi Perumahan Dengan One Gate Sytem Terbaik Di Sidoarjo,Surabaya,Gubeng,40,90,299999999,130,Small
dijual rumah 2 lantai baru di raya bukit palma citraland surabaya,Surabaya,Citraland,250,200,3500000000,450,Large
jual cepat rumah citraland utama dekat dengan gwalk,Surabaya,Citraland,300,210,4500000000,510,Large
JUAL RUMAH MINIMALIS MEWAH DARMO PERMAI TIMUR SURBAYA,Surabaya,,195,110,2850000000,305,Large
Rumah Citraland SIAP HUNI HOOK,Surabaya,Citraland,300,195,4300000000,495,Large
Rumah Baru 1 Lantai Type 45 Medokan Ayu Rungkut Surabaya,Surabaya,Rungkut,45,109,935000000,154,Small
JUAL CEPAT RUMAH ARAYA TAHAP 1,Surabaya,Galaxy,450,240,7000000000,690,Large
Rumah Sangat Bagus dan Murah  Lokasi Dekat Pusat Kota sgt Strategis,Surabaya,Rungkut,42,75,169000000,117,Small
Jual rumah murah,Surabaya,Medokan Ayu,50,45,675000000,95,Small
RUMAH MINIMALIS MURAH 2 LANTAI CUMA 600JT DI SURABAYA BARAT,Surabaya,,80,80,650000000,160,Small
Hunian Murah Bagus Kekinian Harga Diskon Ciamik,Surabaya,Gubeng,42,75,199000000,117,Small
Rumah Promo Murah di Sidoarjo di bawah 200 juta,Surabaya,Ngagel,36,75,199000000,111,Small
Rumah Royal Residence Best View Danau,Surabaya,Wiyung,60,40,1190000000,100,Small
Rumah Cantik Royal Residence Siap Huni,Surabaya,Wiyung,140,114,2750000000,254,Medium
Rumah Royal Residence Best View Danau Full Marmer,Surabaya,Wiyung,384,240,6500000000,624,Large
Rumah Royal Residence Modern Minimalis Siap Huni,Surabaya,Wiyung,126,135,2200000000,261,Medium
Rumah Royal Residence Raya Luar Cluster Modern Minimalis,Surabaya,Wiyung,500,387,6500000000,887,Large
Rumah Bukit Golf Internasional NEW MINIMALIS,Surabaya,,500,300,9500000000,800,Large
Rumah Siap Huni Wonorejo Surabaya,Surabaya,Wonorejo,203,203,2000000000,406,Large
RUMAH CITRALAND CLUSTER TERDEPAN MURAH,Surabaya,Citraland,325,264,4900000000,589,Large
RUMAH BARU GRESS DESAIN MODERN MANYAR dekat dengan galaxy mall,Surabaya,Mulyorejo,240,150,4200000000,390,Large
DIJUAL CEPAT PALING MURAH HITUNG TANAH Rumah Manyar Kertoarjo,Surabaya,Mulyorejo,250,467,8500000000,717,Large
Rumah Citraland CLUSTER PALING DEPAN dekat HONDA CITRALAND,Surabaya,Citraland,350,220,5800000000,570,Large
PALING MURAH SE GRAHA NATURA CLUSTER GARDENVILLE FULL FURNISHED,Surabaya,Lontar,148,102,2750000000,250,Medium
Rumah Raya Tenggilis Mejoyo STRATEGIS,Surabaya,,200,253,4000000000,453,Large
Rumah Baru 2 lantai Semolowaru Elok Surabaya,Surabaya,Semolowaru,110,114,1290000000,224,Medium
Dijual Rumah Hitung Tanah Tengilis Mejoyo Selatan Murah Kendangsari,Surabaya,Tenggilis Mejoyo,200,325,3000000000,525,Large
Rumah Citraland Furnished 2 lantai,Surabaya,Citraland,150,105,1975000000,255,Medium
Rumah di Taman Pondok Indah ME,Surabaya,Wiyung,260,289,2700000000,549,Large
Rumah Manyar Tirtoyoso Selatan Colonial Modern STYLE 2 lantai,Surabaya,,194,194,4500000000,388,Large
Rumah  Gress 2 LT Bukit Palma,Surabaya,Lakarsantri,170,120,1850000000,290,Large
Gubeng Surabaya  Rumah Murah 2Lt Siap Huni 144 m2 SHM di Pucang,Surabaya,Pucangsewu,144,144,1600000000,288,Medium
Sukolilo Surabaya  Rumah Full Furnished 144m Park Regency ITS,Surabaya,Sukolilo,200,144,1700000000,344,Large
Rumah The Mansion Pakuwon Indah STRATEGIS MINIMALIS,Surabaya,,150,162,3900000000,312,Medium
Rumah Serasa Villa Royal Residence Surabaya Barat,Surabaya,Wiyung,529,678,9900000000,1207,Large
Rumah Lebak Indah Town House STRATEGIS SIAP HUNI,Surabaya,,140,104,1450000000,244,Medium
Rumah di Raya Darmo Indah  murah ,Surabaya,Sukomanunggal,225,446,4000000000,671,Large
Gununganyar Surabaya  Rumah Baru Pojok SHM di Gn Anyar Mas Selatan,Surabaya,Gunung Anyar,42,72,799000000,114,Small
DIJUAL BRAND NEW MINIMALIS ROYAL RESIDENCE WIYUNG,Surabaya,Wiyung,190,114,2555000000,304,Large
Rumah DP 19 Juta Surabaya Timur Siap Huni,Surabaya,,42,90,660000000,132,Small
DIJUAL RUMAH MEWAH RAFLES GARDEN CITRALAND,Surabaya,,700,550,12500000000,1250,Large
DIJUAL RUMAH MEWAH INTERNATIONAL VILLAGE B3  CITRALAND,Surabaya,,250,150,3950000000,400,Large
Rumah Royal Residence 3 Lantai Dekat Club House,Surabaya,Wiyung,190,14,2550000000,204,Large
Rumah Royal Residence Raya Luar Cluster Smart Home System,Surabaya,Wiyung,190,157,4200000000,347,Large
Rumah Modern Minimalis Graha Famili,Surabaya,Dukuh Pakis,360,328,11000000000,688,Large
DIJUAL CEPAT Rumah Citraland DEKAT DENGAN GWALK,Surabaya,Citraland,357,300,4750000000,657,Large
Rumah Pandugo Baru NEW MINIMALIS,Surabaya,,140,91,1850000000,231,Medium
Dijual Cepat Rumah Darmo Permai Timur,Surabaya,Darmo Permai,500,300,8500000000,800,Large
Rumah 2 lantai di Bukit Palma BE,Surabaya,,170,154,2400000000,324,Large
Dijual Rumah Citraland Baru Modern Minimalis Taman Gapura,Surabaya,Sambikerep,168,128,3100000000,296,Large
DIJUAL RUMAH  MEWAH SUTOREJO UTARA,Surabaya,,175,100,2650000000,275,Large
Rumah Baru Gress Royal Residence Surabaya Barat,Surabaya,Wiyung,65,50,1200000000,115,Small
Rumah Cantik Royal Residence Surabaya Barat,Surabaya,Wiyung,160,128,2600000000,288,Large
Rumah Central Park A Yani STRATEGIS SIAP HUNI,Surabaya,,180,144,3400000000,324,Large
Rumah di Wisata Bukit Mas dijual ME,Surabaya,Lidah Kulon,400,240,6900000000,640,Large
Rumah 2 Lantai Siap Huni Baratajaya Surabaya,Surabaya,Baratajaya,480,240,10500000000,720,Large
Rumah Siap Huni Rungkut Asri Barat Surabaya,Surabaya,Rungkut,180,200,1550000000,380,Large
Rumah Northwest Park Caspian NEW MINIMALIS,Surabaya,,96,105,1850000000,201,Medium
Rumah Citraland Utama Semi Furnished,Surabaya,Citraland,250,192,4700000000,442,Large
RUMAH SEMI FURNISH GRAHA FAMILI BLOK TERFAVORIT,Surabaya,Dukuh Pakis,600,345,12000000000,945,Large
Rumah Siap Huni Graha Famili,Surabaya,Dukuh Pakis,500,421,10500000000,921,Large
Rumah minimalis Semi Furnish Graha Natura dekat dengan Gwalk,Surabaya,Lontar,281,320,7500000000,601,Large
Rumah Desain Classic CITRALAND UTAMA DEKAT DENGAN GWALK,Surabaya,Citraland,700,450,14000000000,1150,Large
Rumah Citraland Woodland Eastwood Baru Gress Lokasi Strategis,Surabaya,Citraland,330,210,5250000000,540,Large
Rumah Baru Gress Rafles  Rafless  RafflesGarden Citraland,Surabaya,Citraland,400,288,7800000000,688,Large
Rumah Gembong STRATEGIS LANGKA Row 2 mobil,Surabaya,,200,120,950000000,320,Large
Lakarsantri Sby  Rumah Murah 2Lt 283 m2 SHM Dekat Wisma Lidah Kulon,Surabaya,Lakarsantri,350,283,1300000000,633,Large
Rumah Mulyosari STRATEGIS FURNISH,Surabaya,,200,113,1850000000,313,Large
Rumah Alam Galaxy Sambikerep Surabaya Barat,Surabaya,,50,74,1100000000,124,Small
Rumah Hook Royal Residence Cluster Favorit,Surabaya,Wiyung,190,262,4000000000,452,Large
Rumah Dharmahusada Mas STRATEGIS SIAP HUNI,Surabaya,,450,315,4500000000,765,Large
Rumah Hitung Tanah Jalan Kaliwaron Surabaya,Surabaya,Gubeng,211,211,2100000000,422,Large
Rumah Siap Huni Gayungsari Barat Surabaya,Surabaya,Gayungan,200,300,4000000000,500,Large
Rumah Dharmahusada Mas STRATEGIS SIAP HUNI,Surabaya,,450,315,4500000000,765,Large
Rumah Surabaya 2 Lantai Under 15M,Surabaya,Sambikerep,94,104,1400000000,198,Medium
DIJUAL Cepat Rumah Manyar Rejo,Surabaya,Menur Pumpungan,400,300,3500000000,700,Large
Rumah dijual 2 lantai di Somerset Citraland BE,Surabaya,Citraland,350,240,5800000000,590,Large
Rumah baru dibangun berlokasi di Woodland BE,Surabaya,Citraland,330,210,5250000000,540,Large
ARDENVILLE RESIDENCE RUMAH MINIMALIS MERR PENGGANTI APARTEMEN,Surabaya,Gunung Anyar,45,65,835000000,110,Small
Rumah Royal Residence Addington MINIMALIS SIAP HUNI,Surabaya,,263,268,3400000000,531,Large
Rumah Citraland Full Furnished tinggal bawa koper,Surabaya,Citraland,225,160,3949000000,385,Large
Termurah Rumah Graha Famili Full Furnished  Full Marmer Modern Premiu,Surabaya,Graha,450,360,11000000000,810,Large
Dijual Rumah di Babatan Pilang siap huni murah lokasi strategis,Surabaya,Wiyung,144,135,1500000000,279,Medium
RUMAH LUAS TENTRAM DAN NYAMAN,Surabaya,Menur Pumpungan,600,700,11000000000,1300,Large
Rumah Citraland 1 lantai SIAP HUNI cocok untuk orang tua,Surabaya,Citraland,150,207,3000000000,357,Medium
Hunian Dekat Dari Bandara Juanda Dekat Dengan Rencana OERR,Surabaya,Gubeng,42,75,230000000,117,Small
Harga Promo Termurah Dan Terbaik  Rumah Type 4275 Nonsubsidi,Surabaya,Gayungan,42,75,179000000,117,Small
Hunian Termurah Dilokasi Bagus Dan Strategis Dilengkapi Fasilitas,Surabaya,Gayungan,42,75,189000000,117,Small
Rumah baru gress di Rungkut Yakaya,Surabaya,Rungkut Menanggal,130,90,1400000000,220,Medium
Perumahan Baru Regency One Pogot Selangkah Ke Raya Kenjeran Surabaya,Surabaya,Kedung Cowek,61,65,1058000000,126,Small
MURAAH KEBANGETAN RUMAH SELUAS 334M HOOK di RUNGKUT SURABAYA HANYA 3 MILYAR,Surabaya,Rungkut,250,334,3300000000,584,Large
RUMAH MODERN KLASIK FULL FURNISHED SMARTHOME DAN PRIVATE POOL TERMURAH DI SRBYA,Surabaya,Gayungan,500,300,6500000000,800,Large
Rumah Siap Huni Wonorejo Surabaya Utara Nol Jalan Raya,Surabaya,Wonorejo,100,100,750000000,200,Medium
Dijual Murah Rumah Wisata Bukit MasFurnishedada kolam renang,Surabaya,Wiyung,725,420,7800000000,1145,Large
JUAL CEPAT Rumah Baru Gress Citraland Greenlake dekat Raya Wiyung,Surabaya,Wiyung,243,200,3700000000,443,Large
Rumah Full Furnish Citraland Utama dekat Gwalk,Surabaya,Citraland,350,200,4500000000,550,Large
Rumah Baru 2 Lantai Bagus di Surabaya,Surabaya,Gubeng,100,78,825000000,178,Medium
RUMAH FULL FURNISHED MAINROAD WISATA BUKIT MAS DEKAT RAYA WIYUNG,Surabaya,Wiyung,725,420,7500000000,1145,Large
DIJUAL RUMAH TENGAH KOTA SURABAYA JL SIAK NO 15  BANGUNAN LAWAS,Surabaya,Darmo,175,258,5250000000,433,Large
jual rumah,Surabaya,Pakis,155,175,650000000,330,Large
Dijual Rumah di Pakuwon City Grand Island Zimbali Costa,Surabaya,,78,60,2000000000,138,Small
Perumahan New Royal 1 Graha Gunung Anyar Tambak Surabaya,Surabaya,Gunung Anyar,63,48,670000000,111,Small
Jual rumah Ready,Surabaya,Sukolilo,60,42,785000000,102,Small
Rumah Ready Siap KPR minimalis mewah dekat kampus,Surabaya,Rungkut,100,60,650000000,160,Medium
Jual Rumah Siap Huni Tambakrejo Surabaya,Surabaya,Tambakrejo,285,142,1000000000,427,Large
Rumah 3 M an di Citraland,Surabaya,Citraland,200,222,3000000000,422,Large
Dijual Rumah Baru Medayu Tambak,Surabaya,,40,53,600000000,93,Small
RUMAH MINIMALIS MURAH DI CITRALAND UTAMA SURABAYA,Surabaya,,450,280,3990000000,730,Large
RUMAH VILA VALENSIA SAMBIKEREP SURABAYA BARAT,Surabaya,,135,172,2800000000,307,Medium
RUMAH WISATA BUKIT MAS 2 SURABAYA BARAT FULL FURNISHED,Surabaya,,725,420,7800000000,1145,Large
citraland international village murah hitung tanah saja hot,Surabaya,Citraland,80,96,1150000000,176,Small
DitR DIJUAL GRESS  RUMAH JEMURSARI SURABAYA,Surabaya,,190,153,2600000000,343,Large
Rumah Usaha Ngagel Madya SANGAT STRATEGIS COCOK UNTUK SEGALA USAHA,Surabaya,,144,240,3000000000,384,Medium
JUAL RUMAH 1 LANTAI DI WIYUNG INDAH SBY BARAT Tjin2Area ,Surabaya,Wiyung,120,120,1088000000,240,Medium
JUAL RUMAH DI KEPUTIH TEGAL TIMUR  SBY Tjin2Area,Surabaya,Keputih,120,200,1300000000,320,Medium
Dijual Tanah  Bangunan Komersial Area Raya Tenggilis,Surabaya,,200,673,10768000000,873,Large
RUMAH GRAHA FAMILI SURABAYA DIBAWAH HARGA PASAR,Surabaya,,950,766,15500000000,1716,Large
RUMAH SUTOREJO PRIMA SELATAN SURABAYA,Surabaya,,600,430,7000000000,1030,Large
Rumah Baru Minimalis Di Wonorejo Selatan Surabaya,Surabaya,Wonorejo,70,48,735000000,118,Small
Rumah Wisma Tengger Surabaya Barat,Surabaya,,116,120,1100000000,236,Medium
Rumah Graha Natura 2M an sudah Sertifikat Hak Milik dekat clubhouse,Surabaya,Lontar,74,90,2100000000,164,Small
RUMAH DIJUAL DI RUNGKUT SURABAYA,Surabaya,Rungkut,98,56,1485000000,154,Medium
Butuh cepat  Rumah di Green Hill Citraland,Surabaya,Citraland,125,135,2400000000,260,Medium
Bukit Palma Citraland Surabaya Jawa Timur,Surabaya,Citraland,200,200,1790000000,400,Large
Dijual Rumah Baru Gress Minimalis Villa Valensia Pakuwon Surabaya Barat,Surabaya,,180,120,2250000000,300,Large
Rumah Rungkut Asri Timur STRATEGIS LINGKUNGAN BAGUS DAN AMAN,Surabaya,,86,400,4400000000,486,Small
Rumah di Bukit Palma Citraland termurah,Surabaya,Citraland,50,84,700000000,134,Small
DIJUAL BARU RUMAH SIAP HUNI DI SURABAYA,Surabaya,,110,135,950000000,245,Medium
JUAL RUMAH DI NGINDEN JAYA  SBY Tjin2Area,Surabaya,Nginden,168,140,1300000000,308,Large
Dijual Rumah di Rungkut Permai Terawat Siap Huni Hanya 1 menit ke Pasa,Surabaya,Rungkut,145,90,1200000000,235,Medium
Rumah 2 Lantai Baru Gress Modern Minimalis Luas dan Siap Huni,Surabaya,Citraland,170,154,2300000000,324,Large
RUMAH NORHTWEST PARK CITRALAND SURABAYA BARAT,Surabaya,,103,72,1377400000,175,Medium
RUMAH BABATAN PANTAI SURABAYA TIMUR,Surabaya,,144,144,1900000000,288,Medium
Rumah Pondok Benowo Indah Surabaya Barat,Surabaya,,2002,300,2000000000,2302,Large
Rumah Villa Taman Gapura Citraland Surabaya Barat,Surabaya,,180,210,2600000000,390,Large
Hunian Indah Sangat Strategis Hanya 325 Juta ,Surabaya,Ketintang,42,72,325000000,114,Small
Hunian Termuurah Didekat Airport Lokasi Strategis Dekat Pusat Kota,Surabaya,Gunung Anyar,42,75,169000000,117,Small
Rumah Citraland Terawat Siap Huni,Surabaya,Citraland,350,280,4800000000,630,Large
RUMAH DIJUAL DI SURABAYA MODERN BONUS KITCHENSET DAN TAMAN NEGO,Surabaya,Rungkut,140,102,2100000000,242,Medium
Rumah Minimalis Fully Furnished Graha Natura The Next Graha Famili,Surabaya,Lontar,284,320,7700000000,604,Large
Dijual Rumah Minimalis 2 Lantai Siap Huni Wiguna Timur VII Surabaya,Surabaya,Gunung Anyar,103,80,895000000,183,Medium
Hunian Gress American Minimalis 2 Lt Super Mewah Pakuwon Indah,Surabaya,Wiyung,700,375,15900000000,1075,Large
Rumah Baru Minimalis Citraland Utama,Surabaya,Citraland,280,200,4500000000,480,Large
Rumah MURAH Hitung Tanah Citraland Dekat Gwalk,Surabaya,Citraland,60,96,1600000000,156,Small
Rumah Baru Shm Siap Huni The Green Tamansari Sememi Benowo Surabaya,Surabaya,Benowo,56,200,1150000000,256,Small
Rumah Minimalis Wisata Bukit Mas Under 2M dekat raya wiyung,Surabaya,Wiyung,76,60,1850000000,136,Small
Rumah Type 4275 Dekat Juanda Akses Mudah Harga Diskon,Surabaya,Gayungan,42,75,230000000,117,Small
Rumah Citraland Utama Hitung Tanah,Surabaya,Citraland,150,150,2350000000,300,Medium
Modern Tropical House,Surabaya,,78,84,1200000000,162,Small
Rumah Green Lake Wonorejo STRATEGIS ROW JALAN 10M,Surabaya,,180,86,1250000000,266,Large
RUMAH WISATA BUKIT MAS SURABAYA BARAT,Surabaya,,344,471,10000000000,815,Large
Brand New Premium House with Swimming Pool Graha Famili Estate Surabaya,Surabaya,Wiyung,450,360,16000000000,810,Large
Rumah Northwest Lake STRATEGIS LISTRIK 2200W,Surabaya,,45,50,875000000,95,Small
Jual rumah surabaya,Surabaya,Semolowaru,60,55,775000000,115,Small
rumah milenial ready KPR surabaya selatan dekat UK Petra,Surabaya,Wonocolo,75,45,900000000,120,Small
RUMAH SATELIT INDAH DENGAN INCOME PASIF DEKAT MITRA KELUARGA BEAA082,Surabaya,Darmo,500,300,3350000000,800,Large
RUMAH MODERN TERMURAH SURABAYA,Surabaya,,216,375,5000000000,591,Large
Rumah Mewah Murah Siap Huni,Surabaya,Wiyung,325,240,5500000000,565,Large
RUMAH MODERN TERMURAH SURABAYA,Surabaya,,216,375,5000000000,591,Large
Jual Murah Siap Huni Full Furnished,Surabaya,Wiyung,350,240,3800000000,590,Large
RUMAH MEWAH dengan Kolam Renang,Surabaya,Wiyung,400,264,5700000000,664,Large
RUMAH COCOK UNTUK TEMPAT USAHA,Surabaya,,144,144,1500000000,288,Medium
Rumah baru perum rungkut barata surabaya,Surabaya,Rungkut,100,57,1050000000,157,Medium
Rumah Idaman Didekat Pusat Kota Dg Harga Sangat Terjangkau,Surabaya,Rungkut,42,75,179000000,117,Small
Rumah di Pakuwon classic mewah,Surabaya,Pakuwon,1500,1000,38900000000,2500,Large
Rumah 228 Juta di Area Puri Surya Jaya Gedangan,Surabaya,Raya Darmo,36,60,228000000,96,Small
RUMAH GRAHA FAMILY SURABAYA CLUSTER FAVORITE,Surabaya,,522,930,37000000000,1452,Large
Rumah Semi Villa ex Wakapolda,Surabaya,,529,678,11200000000,1207,Large
Dijual rumah murah surabaya timur,Surabaya,Medokan Ayu,36,50,500000000,86,Small
Rumah Graha Famili Blok Favorit,Surabaya,Dukuh Pakis,400,375,11750000000,775,Large
Rumah Semi Furnish Royal Residence dekat raya wiyung,Surabaya,Wiyung,152,144,3200000000,296,Large
Rumah Siap Huni di Gedangan,Surabaya,Kalijudan,42,72,400000000,114,Small
Rumah di  Penjaringan Rungkut,Surabaya,Rungkut,150,100,950000000,250,Medium
RUMAH MURAH MINIMALIS DI CITRALAND UTAMA,Surabaya,,450,280,3990000000,730,Large
Rumah Northwest Park Citraland,Surabaya,Citraland,68,50,880000000,118,Small
RUMAH 2 LANTAI DI SURABAYA,Surabaya,Kutisari,75,50,800000000,125,Small
Rumah Dijual Lokasi Di Perumahan Taman Gunung Anyar,Surabaya,,42,60,550000000,102,Small
RUMAH DIJUAL DI SURABAYA PUSAT HARGA 700 JUTAAN SUDAH 2 LANTAI,Surabaya,Tenggilis Mejoyo,75,50,970000000,125,Small
Rumah Baru Murah di Gedangan,Surabaya,Gunung Anyar,36,60,198000000,96,Small
Dijual Rumah Lokasi Strategis Raya Sukomanunggal  Surabaya  Barat,Surabaya,Sukomanunggal,300,351,8500000000,651,Large
Rumah mewah golf view di Citraland,Surabaya,Citraland,1049,1049,65000000000,2098,Large
Rumah Baru Gress Medokan Ayu Surabaya,Surabaya,Gubeng,110,100,799000000,210,Medium
Gading Regency One Surabaya,Surabaya,Gading,80,50,679000000,130,Small
Jual Cepat Prambanan Residence dkt Raya Wiyung Royal Residence Wisata,Surabaya,Wiyung,350,252,3900000000,602,Large
Rumah Murah Di Medan Tenggara Dekat Tol Amplas Type Cozy,Medan,,53,162,1209000000,215,Small
Dijual Rumah Bentuk Ruko di Jalan Lubuk Kuda Medan,Medan,,64,80,750000000,144,Small
Dijual Rumah Daerah Setiabudi Cicil 8 Tahun Tanpa Bunga,Medan,,70,100,500000000,170,Small
Rumah Setia Budi Medan,Medan,Simpang Selayang,90,211,1372000000,301,Small
VILLA MEGAH  MEWAH 3 Lantai Pertama di Medan Helvetia  GIVENCY ONE,Medan,Helvetia,403,220,3609000000,623,Large
Dijual rumah mewah 30meter ke jalan Large menteng raya,Medan,,90,96,595000000,186,Small
Jual Rumah di Medan Free Biaya Uk 7x18 di Setia budi Ringroad dekat Kampus USU,Medan,Simpang Selayang,90,129,535000000,219,Small
Dijual Rumah Ready Daerah Ringroad Medan  Kanopi Jerjak dan Pagar,Medan,Sunggal,52,86,525000000,138,Small
KOMPLEK SETIABUDI SIMPANG SELAYANG PROMO CASH 346JT,Medan,Tanjungsari,45,84,352800000,129,Small
Perumahan di Medan Free Biaya Uk 7x18 m di Setia budi dekat Ringroad kampus USU,Medan,Simpang Selayang,85,130,535000000,215,Small
Rumah INDENT MURAH DI SETIABUDI SIMPSELAYANG MEDAN,Medan,Simpang Selayang,45,78,346500000,123,Small
DIJUAL RUMAH 2 LANTAI DALAM KOMPLEK DI EKA SUKA DEKAT EKA RASMI MEDAN JOHOR,Medan,Medan Johor,97,90,850000000,187,Medium
Rumah Hunian minimalis J City Tipe Vienna,Medan,Medan Johor,72,90,1098900000,162,Small
RUMAH MURAH PAKAI SUNDA PLAFOND KAWASAN MEDAN SELAYANG SETIABUDI,Medan,Simpang Selayang,53,84,384900000,137,Small
Dijual Rumah Baru Dalam Komplek Merci Type 92,Medan,Medan Johor,92,75,758800000,167,Medium
Dijual Rumah Mewah Taman Setia Budi Indah 1 Medan Medan Selayang,Medan,Simpang Selayang,550,263,5500000000,813,Large
Komplek Villa Setia Budi dengan harga TERMURAH,Medan,,78,80,550000000,158,Small
Rumah Medan Baru diatas lahan luas dan lokasi nyaman,Medan,Medan Baru,275,577,4500000000,852,Large
Komplek J City Residence Rumah 25 Lantai,Medan,Medan Johor,112,112,1200000000,224,Medium
Rumah Hunian Mewah Elegant J City Tipe Jade,Medan,Medan Johor,175,130,2053000000,305,Large
Ruko 2 12 lantai dijual cepat 14 M nego,Medan,Kwala Bekala,200,120,1395000000,320,Large
Jual Rumah Di Medan Area Tipe 80,Medan,Medan Kota,80,72,750000000,152,Small
PROMO RUMAH MURAH SIAP HUNI DI ALFAKA TANJUNG MULIA MEDAN,Medan,Tanjung Mulia Hilir,90,144,742000000,234,Small
Daerah Yos Sudarso JL YOS SUDARSO dekat PT Musim Mas,Medan,Medan Deli,84,54,768000000,138,Small
dijual ruko di balige pandau Hulu kota medan uk 4x22 harga 2050 m Nego,Medan,Pandau Hulu I,216,88,2050000000,304,Large
Di Jual 2 Unit Town House Komplek Tuasan Permata Krakatau Medan,Medan,Medan Area,8,88,1650000000,96,Small
Rumah Tembung Strategis dekat ke kota Medan,Medan,Medan Kota,80,70,450000000,150,Small
Ruko Daerah Kapten Muslim,Medan,,40,16,700000000,56,Small
DIJUAL RUMAH KOMPLEK MENTARI SEJATI,Medan,,40,60,900000000,100,Small
Rumah Mewah Strategis di Villa Jati Mas,Medan,,336,140,7250000000,476,Large
RUMAH CANTIK DI TJ GUSTA,Medan,Medan Helvetia,45,72,395000000,117,Small
Perumahan Vienna Botanical Living Cluster Vivaldi Tipe A,Medan,,74,63,788000000,137,Small
RUMAH DI SETIA BUDI,Medan,Medan Selayang,60,84,480000000,144,Small
Daerah Ringroad Millenium Plaza JL BUDI LUHUR,Medan,Medan Helvetia,80,90,788000000,170,Small
Perumahan Vienna Botanical Living Cluster Vivaldi Hook Blok O,Medan,,122,100,1812950000,222,Medium
Beli Rumah Mewah Setia Budi MEDAN Seperti Beli 2 Rumah,Medan,Sunggal,124,120,1300000000,244,Medium
RUMAH BARU KAMAR 3 DEKAT BANDARA KUALANAMU,Medan,Tembung,90,135,320000000,225,Small
Daerah Sekip The Penthouse Jalan Buku,Medan,Medan Petisah,85,40,688000000,125,Small
Rumah Hokki Sunggal Harga Bersahabat,Medan,,120,152,2500000000,272,Medium
Rumah Villa The Somerset Regency Medan Di  Cepat,Medan,,178,214,2880000000,392,Large
Rumah Murah dekat RS Adam Malik Medan Ukuran Tanah yg luas,Medan,,45,105,350000000,150,Small
Rumah Murah di Sunggal Kanan Dapatkan Gratis Semua Biaya,Medan,,50,96,320000000,146,Small
Rumah Modern Sekitar SM Raja Amplas,Medan,,45,72,330000000,117,Small
Ruko siap Huni disamping Terminal Amplas,Medan,Amplas,180,60,1150000000,240,Large
DIJUAL RUMAH BARU READY DI INTI KOTA MEDAN NGUMBAN,Medan,Simpang Selayang,45,72,455000000,117,Small
RUMAH KOMPLEK TERBARU DI AMPLAS,Medan,Medan Amplas,50,84,450000000,134,Small
Dijual rumah jalan sei asahan kota medan,Medan,Sunggal,50,105,565000000,155,Small
Perumahan Vienna Botanical Living Cluster Vivaldi Blok I,Medan,,104,75,1045350000,179,Medium
Daerah Marelan Jl Marelan 1,Medan,Medan Marelan,55,72,388000000,127,Small
CitraLand Gama City Medan_Cluster Demsey Hill  Type Lamberton 8x15,Medan,,111,120,2801821250,231,Medium
Ruko Townhouse Strategis di Kota Medan,Medan,Medan Tenggara,72,1000,588000000,1072,Small
HUNIAN READY MEDAN AMPLAS HARGA 700 AN,Medan,Amplas,84,84,775000000,168,Small
PERUMAHAN NYAMAN DI SUNGGAL MEDAN,Medan,Medan Sunggal,50,96,370000000,146,Small
Jl Gagak Hitam  Ringroad Komplek Bumi Seroja Permai,Medan,Medan Sunggal,135,180,1600000000,315,Medium
Rumah Mewah BANJIR PROMO Buruan cek disini sebelum Promo Berakhir,Medan,,80,210,800000000,290,Small
DIJUAL RUMAH MEWAH SIAP HUNI DI KOMPLEK TAMAN RIVIERA,Medan,Amplas,540,216,2500000000,756,Large
BARU JOHOR SUCILAND REGENCY,Medan,Medan Johor,115,199,1200000000,314,Medium
Cengkeh Mas Residence,Medan,,150,90,1100000000,240,Medium
DENGAN DESAIN BARU BEDA DARI YANG LAIN KARNA DESAIN YANG KAMI BERIKAN BAGUS,Medan,Sunggal,50,90,510000000,140,Small
1 menit ke Jl Adam malik Jl Setia  Komplek Rukun Mas,Medan,Medan Barat,130,60,2300000000,190,Medium
Daerah Tempuling  Bhayangkara JL MEDAN UTARA,Medan,Indra Kasih,120,68,840000000,188,Medium
NATURAL HARMONY GRATIS BIAYA NOTARIS KPR PAJAK Rp 0  GRATIS ANGSURAN 36 BULAN,Medan,,90,84,668000000,174,Small
Dijual Ruko jalan Sumatera Medan,Medan,Pandau Hulu I,300,130,6300000000,430,Large
Rumah Mewah di Ringroad Dapatkan gratis Semua Biaya,Medan,,45,84,400000000,129,Small
Rumah Ready MURAH Dan LUAS di AMPLAS,Medan,Amplas,50,84,475000000,134,Small
HUNIAN CANTIK DI AMPLAS,Medan,Amplas,50,84,450000000,134,Small
BELI RUMAH GRATIS JALAN JALAN,Medan,Amplas,65,115,369000000,180,Small
Rumah Contoh Mayfair Cattleya Tinggal Angkat Koper,Medan,,90,182,1908800000,272,Small
DiJual Villa RiverView Polonia Medan,Medan,Polonia,720,360,15000000000,1080,Large
RUMAH 2 LANTAI BISA BUKA USAHA,Medan,Helvetia Timur,60,102,625000000,162,Small
RUMAH 2 LANTAI TERBATAS DI SETIA BUDI,Medan,Medan Sunggal,84,90,530000000,174,Small
TERBATAS UNIT DI SETIA BUDI,Medan,Medan Selayang,100,96,730000000,196,Medium
HUNIAN CANTIK DI SM RAJA,Medan,Amplas,45,72,400000000,117,Small
KOMPLEK CANTIK DI AMPLAS,Medan,Medan Amplas,50,84,475000000,134,Small
RUMAH TERBANYAK AKAN DI BANGUN DI SIMP PEMDA SETIA BUDI,Medan,Simpang Selayang,85,112,790000000,197,Small
Perumahan mewah nyaman 10 mnt k USU,Medan,Medan Selayang,72,97,490000000,169,Small
Perumahan cantik nyaman 1 mnt k pjk melati,Medan,Medan Tuntungan,50,84,500000000,134,Small
Perumahan strategis 5 mnt kpjk melati,Medan,Medan Selayang,50,84,450000000,134,Small
Perumahan strategis 5 mnt kpjk melati,Medan,Medan Selayang,50,84,450000000,134,Small
Perumahan mewah nyaman 5 mnt k pjk melati,Medan,Medan Selayang,50,84,450000000,134,Small
DIJUAL RUMAH DAERAH KEJAKSAAN,Medan,Medan Petisah,50,93,495000000,143,Small
CLUSTER FADHILA SETIABUDI,Medan,Medan Selayang,50,72,350000000,122,Small
Perumahan mewah murah nyaman,Medan,Medan Sunggal,120,108,1075000000,228,Medium
Perumahan strategis nyaman1 mntk pjk melati,Medan,Medan Tuntungan,50,84,500000000,134,Small
Perumahan strategis 5 mnt kpjk melati,Medan,Medan Selayang,50,84,450000000,134,Small
Perumahan strategis 5 mnt kpjk melati,Medan,Medan Selayang,50,84,450000000,134,Small
Perumahan mewah nyaman strategis 20 mnt k USU,Medan,Simpang Selayang,50,80,375000000,130,Small
Perumahan cantik nyaman 3 mnt k supermarket maju bersama,Medan,Gedung Johor,45,78,500000000,123,Small
Perumahan mewah nyaman 5 mnt k pjk melati,Medan,Medan Selayang,50,84,450000000,134,Small
Perumahan cantik nyaman 1 mnt k pjk melati,Medan,Medan Tuntungan,50,84,500000000,134,Small
Perumahan mewah nyaman 5 mnt k pjk melati,Medan,Medan Selayang,50,84,450000000,134,Small
Perumahan mewah murah nyaman,Medan,Medan Sunggal,120,108,1075000000,228,Medium
DIJUAL RUMAH DENGAN HARGA MURAH,Medan,Medan Selayang,72,97,490000000,169,Small
Cluster Holland Merci Type Vorden,Medan,Gedung Johor,102,84,1033800000,186,Medium
Perumahan cantik nyaman 1 mnt k pjk melati,Medan,Medan Tuntungan,50,84,500000000,134,Small
Perumahan strategis 5 mnt kpjk melati,Medan,Medan Selayang,50,84,450000000,134,Small
Perumahan cantik nyaman 20 mnt k USU,Medan,Medan Selayang,50,84,450000000,134,Small
Rumah tyoe Akime PIK 2 Jakarta,Medan,Medan Petisah,90,197,3335000000,287,Small
Perumahan cantik nyaman 1 mnt k pjk melati,Medan,Medan Tuntungan,50,84,500000000,134,Small
Perumahan strategis nyaman1 mntk pjk melati,Medan,Medan Tuntungan,50,84,500000000,134,Small
Perumahan mewah murah nyaman,Medan,Medan Sunggal,75,80,550000000,155,Small
BELI RUMAH DI SIMP PEMDA,Medan,Simpang Selayang,84,84,530000000,168,Small
RUMAH DEKAT JALAN RAYA DAN RCW RINGROAD,Medan,Sunggal,100,112,850000000,212,Medium
TELAH DI BANGUN RUMAH DEKAT JL RINGROAD,Medan,Sunggal,100,105,850000000,205,Medium
RUMAH READY CANTIK BISA USAHA DI GATSU,Medan,Medan Area,65,102,625000000,167,Small
RUMAH HARGA MURAH BISA UNTUK INVESTASI,Medan,Sunggal,100,108,630000000,208,Medium
Rumah Vanda Mayfair Medan Tinggal Angkat Koper,Medan,,89,84,1325000000,173,Small
Rumah Cattleya Hadap Timur di Mayfair Medan,Medan,,90,202,1300000000,292,Small
PERUMAHAN CLUSTER MEWAH,Medan,Sunggal,87,87,285000000,174,Small
DIJUAL PERUMAHAN TERBARU DAN TERNYAMAN JOHOR SUCILAND REGENCY,Medan,Medan Johor,110,115,900000000,225,Medium
Cluster Demsey Hill  Tipe WINDSOR 6x15,Medan,,75,90,1955220000,165,Small
DAPATKAN JALAN JALAN KE TURKI DENGAN BELI RUMAH DISINI,Medan,Amplas,60,115,359000000,175,Small
DIJUAL PERUMAHAN JOHOR SUCILAND REGENCY,Medan,Medan Johor,108,166,570000000,274,Medium
PERUMAHAN MEWAH DI SM RAJA KOTA MEDAN,Medan,Padang Bulan,75,105,600000000,180,Small
HANYA 3 UNIT SAJA RUMAH DEKAT SETIA BUDI,Medan,,60,84,480000000,144,Small
Rumah Mewah sekitar KAPTEN MUSLIM DAPATKAN DISKON SAMPAI 100 JTAN,Medan,,150,108,950000000,258,Medium
DI NGUMBAN SURBAKTI AKAN DI BANGUN RUMAH CANTIK,Medan,Simpang Selayang,50,84,480000000,134,Small
RUMAH CANTIK DI MEDAN TUNTUNGAN,Medan,Sunggal,50,93,450000000,143,Small
RAMAI PENDUDUK RUMAH DI SAVERIA,Medan,,100,108,630000000,208,Medium
RUMAH CANTIK ALA BALI DI TJ GUSTA,Medan,Helvetia Timur,45,72,425000000,117,Small
READY RUMAH CANTIK DI GATSU,Medan,Helvetia Timur,65,102,625000000,167,Small
BURUANN BOOKING RUMAH DI SETIABUDI,Medan,,65,84,385000000,149,Small
MILIKI RUMAH DENGAN WARNA YANG BEBAS ANDA PILIH SESUKA HATI YANG MASTINYA MURAH,Medan,Medan Johor,50,78,400000000,128,Small
RASAKAN UNIKNYA RUMAH ALAH EROPA CUMA ADA DI NAFISYAH REGENCEY  CUMA 5XXXJUTA,Medan,Sunggal,50,90,525000000,140,Small
HUNIAN MURAH CUMA 4XXXSANJUTA AJA UDAH DAPAT RUMAH DENGAN DESAIN EROPA INI LOHH,Medan,Sunggal,50,90,490000000,140,Small
AYOO GUYSS JANGAN MAU KEHABISAN HUNIAN MEWAH INI CUMA ADA DISINI CUMA 6XXXJT AJA,Medan,Medan Kota,50,102,625000000,152,Small
WUJUDKAN RUMAH IMPIAN MU HANYA DI PONDOK INDAH SETIA BUDI CUMA 6XXXJUTA AJA LOH,Medan,Sunggal,50,105,625000000,155,Small
DENGAN 7XXJT AJA UDAH DAPAT RUMAH SEMEWASH INI LOH GUYS DENGAN FASILITAS LENGKAP,Medan,Medan Johor,70,132,790000000,202,Small
RUMAH SECOND DI GAPERTA UJUNG,Medan,Helvetia,91,91,430000000,182,Medium
RUMAH DEKAT TOL DI TJ GUSTA,Medan,Helvetia Tengah,45,72,395000000,117,Small
LAUNCHING RUMAH MURAH DI SETIA BUDI,Medan,Simpang Selayang,60,84,480000000,144,Small
RUMAH DEKAT RS ADAM MALIK,Medan,Medan Tuntungan,50,93,450000000,143,Small
READY RUMAH DEKAT JALAN RINGROAD SETIA BUDI,Medan,Medan Selayang,100,126,850000000,226,Medium
RUMAH CANTIK DI NGUMBAN SURBAKTI,Medan,Medan Sunggal,65,84,680000000,149,Small
READY RUMAH CANTIK DI AMPLAS,Medan,Medan Amplas,84,84,760000000,168,Small
HUNIAN CANTIK DI SETIA BUDI,Medan,Medan Selayang,84,90,650000000,174,Small
READY RUMAH DI SM RAJA AMPLAS,Medan,Medan Amplas,84,84,760000000,168,Small
BELI RUMAH GRATIS JALAN JALAN,Medan,Amplas,50,93,450000000,143,Small
SIAP HUNI RMH DIJOHORDP 30 JUTA,Medan,Medan Johor,98,45,310000000,143,Medium
RUMAH DI KOTA MEDAN MURAH X,Medan,Medan Amplas,50,72,350000000,122,Small
BELI RUMAH GRATIS JALAN JALAN,Medan,Amplas,50,93,450000000,143,Small
SIAP HUNI RMH DIJOHORDP 30 JUTA,Medan,Medan Johor,98,45,310000000,143,Medium
RUMAH DI KOTA MEDAN MURAH X,Medan,Medan Amplas,50,72,350000000,122,Small
DISKON UNIT PERTAMA PEMBELIAN RUMAH,Medan,Simpang Selayang,84,90,480000000,174,Small
1 LANTAI RUMAH CANTIK DI SIM PEMDA,Medan,Simpang Selayang,54,84,380000000,138,Small
RUMAH CANTIK SETIA BUDI,Medan,Simpang Selayang,84,90,530000000,174,Small
RUMAH CANTIK SETIA BUDI,Medan,Simpang Selayang,65,84,680000000,149,Small
RUMAH CANTIK DI RINGROAD,Medan,Medan Selayang,45,84,480000000,129,Small
HUNIAN BALI DEKAT GIVENCY ONE,Medan,Helvetia Timur,45,72,395000000,117,Small
RUMAH CANTIK DEKAT PAJAK MELATI,Medan,Medan Selayang,54,84,380000000,138,Small
READY RUMAH CANTIK DI GATOT SUBROTO,Medan,Medan Helvetia,65,102,850000000,167,Small
READY RUMAH CANTIK DI GATSU,Medan,Medan Helvetia,65,102,625000000,167,Small
RUMAH CANTIK DI SETIA BUDI,Medan,Medan Selayang,50,93,450000000,143,Small
RUMAH CANTIK SETIA BUDI,Medan,Simpang Selayang,84,90,650000000,174,Small
HUNIAN MILENIAL KEREN DAN ELEGANT ALENA JOHOR PASTINYA MURAH CUMA 5XXSAN JUTA,Medan,Medan Johor,70,65,540000000,135,Small
RUMAH KEREN BAGUS 5XXJT TYPE 70 ANDA UDAH DAPAT RUMAH SEBAGUS INI,Medan,Medan Johor,70,78,590000000,148,Small
DIJUAL RUMAH AMANNYAMAN DAN ASRI  JOHOR SUCILAND REGENCY,Medan,Medan Johor,115,143,1000000000,258,Medium
HUNIAN NUANSA BALI DI TJ GUSTA,Medan,Helvetia,45,84,400000000,129,Small
RUMAH READY DEKAT JALAN RAYA RINGROAD,Medan,Sunggal,100,126,850000000,226,Medium
READY RUMAH CANTIK DI MEDAN BARU,Medan,Helvetia Tengah,65,102,625000000,167,Small
RUMAH 2 LANTAI CANTIK DEKAT SM RAJA DAN AMPLAS,Medan,Amplas,84,84,760000000,168,Small
2 LANTAI RUMAH CANTIK DI GATSU,Medan,Helvetia,65,102,625000000,167,Small
RUMAH CANTIK DI MEDAN AMPLAS,Medan,Medan Amplas,45,75,400000000,120,Small
RUKO CANTIK DI NGUMBAN SURBAKTI,Medan,Medan Sunggal,75,144,985000000,219,Small
RUMAH 1 LANTAI DEKAT PAJAK MELATI,Medan,Simpang Selayang,50,93,380000000,143,Small
RUMAH CANTIK BALI DI TJ GUSTA,Medan,Medan Helvetia,45,84,425000000,129,Small
KAMI PERSEMBAHKAN RUMAH CRISTAL JOHOR UNTUK ANDA DENGAN HARGA MURAH,Medan,Medan Johor,50,87,425000000,137,Small
PERUMAHAN YANG AMAT SANGAT MEWAH CUMA ADA DI MALDINA KARYA 4XXXJUTA,Medan,Medan Kota,50,93,490000000,143,Small
RUMAH DENGAN KONSEP ANDRA MATIN DENGAN TAMPILAN YANG SANGAT ELEGANT PASTINYA,Medan,Medan Johor,70,110,711000000,180,Small
BAGUS LOKASINYA VILLA SAVERIA HANYA 6XXJUTA AJA UDAH DAPAT FASILITAS MEWAH,Medan,Medan Kota,100,108,650000000,208,Medium
AKAN READY RUMAH DI RINGROAD,Medan,Sunggal,100,108,850000000,208,Medium
HUNIAN DEKAT SETIA BUDI RINGROAD,Medan,Simpang Selayang,50,90,510000000,140,Small
HUNIAN CANTIK COCOK UNTUK INVESTASI DI SIMP PEMDA,Medan,Simpang Selayang,100,108,650000000,208,Medium
RUMAH LUAS TYPE 100 DI RINGROAD,Medan,Simpang Selayang,100,126,850000000,226,Medium
RUMAH DEKAT GIVENCY ONE,Medan,Helvetia Timur,45,84,425000000,129,Small
BELI RUMAH BISA JALAN KE LUAR NEGRI,Medan,Amplas,60,115,369000000,175,Small
RUMAH CANTIK DI NGUMBAN SURBAKTI,Medan,Medan Selayang,65,84,680000000,149,Small
RUMAH AKSES JALAN DEKAT RINGROAD,Medan,Medan Sunggal,100,124,850000000,224,Medium
READY RUMAH SIAP HUNI DI GATSU,Medan,Medan Timur,65,102,625000000,167,Small
rRUMAH CANTIK DI RINGROAD,Medan,Medan Selayang,45,84,480000000,129,Small
HUNIAN CANTIK DI KEJAKSAAN SETIA BUDI,Medan,Medan Tuntungan,50,93,435000000,143,Small
RUMAH CANTIK DI KEJAKSAAN SETIA BUDI,Medan,Simpang Selayang,50,93,450000000,143,Small
SIAP HUNI SDH ADA CANOPY RMH DIJOHOR,Medan,Medan Johor,50,72,295000000,122,Small
PROMO RUMAH LOKASI JOHOR,Medan,Medan Johor,50,78,350000000,128,Small
RUMAH YANG DI DESAIN KHUSUS UNTUK ANDA DENGAN RUANGAN FLEKSIBEL DAN MURAH,Medan,Helvetia,68,108,790000000,176,Small
BURUAN MILIKI HUNIAN MURAH MERIAH PERUMAHAN CANTIKA JOHOR DENGAN MEWAH,Medan,Medan Johor,50,78,410000000,128,Small
CANTIKA JOHOR PERUMAHAN BERGENSI DAN PASTINYA BERKUALITAS CUMA 3XXXJUTA AJA,Medan,Medan Johor,50,78,380000000,128,Small
PERUMAHAN VILLA SAVERIA RUMAH STRAREGIS DAN MURAH HANYA 3XXJUTA AJA GUYS,Medan,Medan Kota,54,84,380000000,138,Small
RUMAH TERLARIS KOMPLEKS VILLA SAVERIA HANYA 4XXSAN JUTA AJA,Medan,Medan Kota,64,84,450000000,148,Small
DIJUAL RUMAH KOMPLEK MEWAH ASOKA RAYA SIAP HUNI NYAMAN PASTINYA,Medan,,300,185,1400000000,485,Large
Rumah Mayfair Vanda SemiFurnished Lux,Medan,,89,84,1400000000,173,Small
RUMAH MEWAH DEKAT BANDARA,Medan,Tembung,50,114,295000000,164,Small
HUNIAN DI TJ GUSTA HARGA MULAI 300 JUTA,Medan,Helvetia,45,84,450000000,129,Small
Rumah Mewah Medan Johor Sangat dekat JCity Dapatkan Hadiah2 Menarik,Medan,,80,136,600000000,216,Small
Rumah Termurah di Ringroad Kota Medan 2 Lantai 400 Juta,Medan,,75,84,400000000,159,Small
DIJUAL PERUMAHAN JOHOR SUCILAND REGENCY,Medan,Medan Johor,120,97,850000000,217,Medium
Rumah Mewah di Setiabudi Hanya 5 menitan ke USU,Medan,,54,84,380000000,138,Small
Rumah Mewah di Ringroad Kota Medan,Medan,,45,84,380000000,129,Small
Ruko Strategis di jl AH Nasution Simp Johor Medan,Medan,Pangkalan Mansur,192,72,2100000000,264,Large
PERUMAHAN MEWAH DI RINGROAD MEDAN,Medan,,45,84,425000000,129,Small
Rumah cantik di johor,Medan,Medan Johor,50,78,370000000,128,Small
RUMAH LUAS I MARELAN 1 LANTAI,Medan,Timbang Deli,80,105,488000000,185,Small
TELAH DI BANGUN RUMAH MURAH DEKAT RCW RINGROAD,Medan,Medan Sunggal,100,126,850000000,226,Medium
Dijual Rumah di jln Rantang no20 D Komplek Rantang Mas MedanSumut,Medan,Petisah Tengah,256,84,1350000000,340,Large
JL KUALI SEKIP  MEDAN KUALI RESIDENCE,Medan,Medan Petisah,92,60,725000000,152,Medium
GRATIS JALAN JALAN KE TURKI UNTUK PEMBELIAN RUMAH,Medan,Amplas,60,115,350000000,175,Small
dijual rumah 2 lantai SM Raja Medan,Medan,Amplas,84,96,625000000,180,Small
Dijual Rumah Komplek Taman Kasuari Indah Medan,Medan,Sunggal,550,403,4000000000,953,Large
DIJUAL PERUMAHAN TERBARU JOHOR SUCILAND REGENCY,Medan,Medan Johor,110,142,1000000000,252,Medium
Rumah Mewah hanya 500 m dari Rs Adam Malik Medan Ukuran Tanahnya Menarik,Medan,Simpang Selayang,80,210,800000000,290,Small
Rumah Medan  Halton Place  PROMO DP 0 Persen dan Free PPn,Medan,,200,135,1901000000,335,Large
RUMAH DEKAT FLAMBOYAN,Medan,Sunggal,64,84,450000000,148,Small
Rumah Mewah di Ngumban Surbakti dekat Kampus Kebidanan  Keperawatan Elizabeth,Medan,,45,84,380000000,129,Small
BELI RUMAH GRATIS JALAN JALAN KE TURKI,Medan,Amplas,60,155,369000000,215,Small
Dijual Rumah Perumahan Givency One Akses Strategis dekat Pintu Tol Medan,Medan,Helvetia,89,84,1010400000,173,Small
Dijual Rumah Full Furnish Tinggal bawa Koper Di Perumahan Givench One Medan,Medan,Helvetia,89,84,1883400000,173,Small
PERUMAHAN TERBARU DAN TERNYAMAN JOHOR SUCILAND REGENCY,Medan,Medan Johor,97,90,800000000,187,Medium
Daerah Krakatau  Jl Purwosari  Krakatau Komplek Carilla Haus,Medan,Medan Timur,86,100,675000000,186,Small
Dijual Villa Taman Anggrek Medan,Medan,Helvetia,598,248,13500000000,846,Large
Ruko strategis di Jl Setia Budi Medan,Medan,Helvetia Timur,192,64,1200000000,256,Large
Dijual Rumah Sudut Full Furnish Medan Kota,Medan,Helvetia,131,96,2500000000,227,Medium
JUAL RUMAH CEPAT  EDISI BU SEBAB AKAN PINDAH TUGAS,Medan,Sunggal,327,327,550000000,654,Large
AKAN DI BANGUN RUMAH DI NGUMBAN SURBAKTI HARGA MULAI 400 JUTA,Medan,Sunggal,85,112,790000000,197,Small
Rumah dipusat kota medan rumah mantan staf ahli menko kesra dan anggota MPR RI,Medan,Polonia,500,885,42000000000,1385,Large
DIJUAL PERUMAHAN JOHOR SUCILAND REGENCY,Medan,Medan Johor,115,142,1000000000,257,Medium
RUMAH MEWAH DENGAN FASILITAS KEREN,Medan,Sunggal,153,157,464000000,310,Large
DIJUAL RUMAH MEWAH SIAP HUNI,Medan,Bangun Mulia,540,216,2500000000,756,Large
RUMAH CANTIK DAPAT JALAN JALAN KE TURKI,Medan,Amplas,60,115,369000000,175,Small
RUMAH LUAS TERLarge DI RINGROAD,Medan,Simpang Selayang,75,144,985000000,219,Small
Rumah murah luas tanah 400 blok tunggal tasbi 1,Medan,,400,400,2800000000,800,Large
Daerah Gajah Mada Jl Sei Tuntung Medan,Medan,Medan Baru,122,66,1250000000,188,Medium
Daerah Ring Road Jl Amal Luhur,Medan,Medan Helvetia,100,93,930000000,193,Medium
DIJUALL RUMAH SIAP HUNI LOKASI JOHOR,Medan,Medan Johor,50,80,370000000,130,Small
DIJUAL RUMAH 3 KAMAR LOKASI P BULAN,Medan,Padang Bulan Selayang II,75,84,500000000,159,Small
Perumahan Wonosari Asri Residence Dengan Kualitas Rumah Mewah Dan Harga Murah,Medan,Medan Kota,39,87,168000000,126,Small
AKAN DIBANGUN UNTUK ANDA PASTINYA UDAH ADA PROMO UNTUK ANDA MILIKI SEKARANG,Medan,Medan Kota,42,87,218000000,129,Small
MEMPERSEMBAHKAN PROJEK TERNAMA CLUSTER COLUMBIA DENGAN HARGA YANG SANGAT MURAH,Medan,Medan Sunggal,50,87,295000000,137,Small
DIJUAL VILLA PONDOK SURYA MEWAH TIPE MEZANINE 5XXAJA BUAT ANDA,Medan,Helvetia,70,90,580000000,160,Small
PERUMAHAN KOMPLEK PONDONKINDAHKEMIR SMRAJA MEDAN SUDAH SHM PASTINYA CUMA 7xxjt,Medan,Medan Kota,70,90,770000000,160,Small
RUMAH SIAP HUNI DI KOMPLEK VILLA SETIA BUDI MEDAN UDAH TURUN HARGA  LOH GUYS,Medan,Medan Kota,92,132,980000000,224,Medium
DIJUAL RUMAH PASTINYA MURAH CUMA 3XXJUTA AJA UNTUK KALIAN BELI YUK BURUAN,Medan,Medan Kota,60,106,385000000,166,Small
PERUMAHAN TERBAIK JOHOR SUCILAND REQUENCY,Medan,Medan Johor,100,90,850000000,190,Medium
PERUMAHAN TERBAIK JOHOR SUCILAND REGENCY,Medan,Medan Johor,115,135,1050000000,250,Medium
SIAP READY RUMAH KEJAKSAAN RESIDENCE 4XXXSAN JUTA AJA UNTUK ANDA MILIKI,Medan,Medan Tuntungan,50,101,435000000,151,Small
ROYAL SEMBADA RUMAH DENGAN TIPE75 DENGAN HARGA 600JT BISA ANDA DAPATKAN,Medan,Simpang Selayang,75,105,600000000,180,Small
Rumah Komplek Murah Griya Nusa Bali Harga Promo Lokasi Strategis Cuma 3xxxjt Aja,Medan,Medan Kota,45,72,375000000,117,Small
DIJUAL RUMAH MEWAH DENGAN HARGA MURAH DENGAN FASILITAS BINTANG LIMA,Medan,Sunggal,60,127,369000000,187,Small
PONDOK INDAH KEMIRI DENGAN KUALITAS YANGTERJAMIN MURAH PALING TOP DEH,Medan,Medan Kota,50,96,595000000,146,Small
TOPAZ GATSU RUMAH MEWAH PALING MURAH YANG BANYAK DIRISET BANYAK ORANG CUMA 23M,Medan,Helvetia,159,172,2300000000,331,Large
DIJUAL RUMAH SUPER LUAS PASTINYA DAN KAWASAN ELIT DENGAN LINGKUNGAN ASRI,Medan,Medan Denai,400,900,2300000000,1300,Large
PERUMAHAN SAKURA PERMAI DENGAN HARGA MURAH CUMA 4XXSAN JUTA AJA LOH,Medan,Medan Kota,105,133,440000000,238,Medium
RUMAH MURAH LOKASI  P BULAN,Medan,Padang Bulan Selayang I,7,84,500000000,91,Small
Rumah baru medan johor,Medan,Medan Johor,70,108,570000000,178,Small
PERUMAHAN TERBAIK JOHOR SUCILAND REGENCY,Medan,Medan Johor,115,189,1200000000,304,Medium
RUMAH IDAMAN KELUARGA,Medan,Sunggal,127,127,369000000,254,Medium
KEJAKSAAN RESIDENCE RUMAH CANTIK 1 LANTAI DAN BAONYAK DICARI ORANG CUMA 5XXXJT,Medan,Medan Tuntungan,50,137,545000000,187,Small
PERUMAHAN ROYAL SEMBADA PERUMAHAN MEWAH BANYAK DIBELI BANYAK ORANG 8XXXJT AJA,Medan,Simpang Selayang,105,105,800000000,210,Medium
Dijual Perumahan Mewah Royal Sembada Village Rumah Murah Dengan Harga 5xxxjuta,Medan,Simpang Selayang,50,105,520000000,155,Small
DIJUAL GRIYA NUSA BALI DENGAN 3XXXJUTA AJA ANDA UDAH DAPAT RUMAH SEBAGUS INI LOH,Medan,Medan Kota,45,72,350000000,117,Small
CLUSTER FADHILA SETIABUDI RUMAH CANTIK  MEWAH PASTINYA MURAH BERKUALITAS,Medan,Medan Selayang,50,72,450000000,122,Small
PERUMAHAN MODERN CLUSTER FADHILA SETIABUDIRINGROAD DENGAN KUALITAS TERBAIK,Medan,Medan Selayang,45,60,400000000,105,Small
KINI HADIR DIHADAPAN ANDA RUMA SUPER MURAH DENGAN KUALTAS TERJAMIN BAGUS,Medan,Medan Kota,39,87,188000000,126,Small
RUMAH CLUSTER KARYA DARMA DENGAN ACCSESS RUMAH YANG SANGAT TERJANGKAU PASTINYA,Medan,Medan Johor,55,80,340000000,135,Small
BANYAK PROMO DIDALAMNYA PONDOK INDAH SETIA BUDI BURUAN BELI DIJAMIN MURAH,Medan,Sunggal,50,105,565000000,155,Small
PALIIING LARIS RUMAH DI VILLA PONDOK SURYA HANYA 4XXXSAN JUTA AJA LOH GUYS,Medan,Helvetia,40,60,425000000,100,Small
Rumah Cantik dan Mewah CUMA DI ALFA MEGA REGENCY HANYA 5XXJUTA AJA KOK,Medan,Sunggal,65,105,550000000,170,Small
RUMAH MURAH DKT KAMPUS USU,Medan,Padang Bulan Selayang II,50,70,570000000,120,Small
PERUMAHAN KEREN MY LALA LAND SRI GUNTING,Medan,Sunggal,45,45,325000000,90,Small
PERUMAHAN GRIYA NUSA BALI DENGAN DESAIN YANG MENARIK DAN INTERIOR BAIK 4XXXJT LO,Medan,Medan Kota,50,84,475000000,134,Small
RUMAH CANTIK MINIMALIS DENGAN HARGA 5XXXJUTA AJA UDAH BISA DAPAT RUMAH INI,Medan,Medan Johor,80,120,580000000,200,Small
RUMAH READY DI TEMBUNG CUMA 3XXSAN JUTA AJA UNTUK BISA ANDA BELI SEKARANG,Medan,Medan Tembung,60,143,370000000,203,Small
RUMAH DENGAN KUALITAS RUMAH YANG MEWAH DENGAN KONSEP DOUBLE DINDING,Medan,Medan Selayang,75,84,725000000,159,Small
Rumah Murah Medan Dekat Bandara Kualanmu,Medan,,51,90,433000000,141,Small
Dijual perumahan terbaik dan ternyaman  Johor Suciland Regency,Medan,Medan Johor,110,115,900000000,225,Medium
JOHOR SUCILAND REGENCY,Medan,Medan Johor,115,189,1200000000,304,Medium
PERUMAHAN DENGAN LOKASI TERBAIK DAN TERNYAMAN JOHOR SUCILAND REGENCY,Medan,Medan Johor,115,143,1000000000,258,Medium
RUMAH DENGAN KAWASAN BERKEMBANG DEKAT KAMPUNG LALANG MEDAN CUMA 4XXXJUTA AJA,Medan,Sunggal,75,144,468000000,219,Small
DIJUAL RUMAH SECONDRY PERUMAHAN GRAND ARAFAH RUMAH MEWAH PASTINYA MURAH,Medan,Helvetia,100,80,720000000,180,Medium
BURUAN CEK RUMAH DKT KAMPUS USU,Medan,Medan Selayang,50,77,570000000,127,Small
The Dallas Jl Pelita 1 Sutomo Ujung Medan,Medan,Medan Perjuangan,96,76,788000000,172,Medium
Daerah Pancing  Jl Pancing II  Komplek Havana,Medan,Medan Tembung,86,36,548000000,122,Small
dijual rumah 1 lantai gatsu medan,Medan,Sunggal,65,102,625000000,167,Small
DiJual Rumah dekat RCW Mall dan Manhattan Mall,Medan,Medan Selayang,320,240,3500000000,560,Large
Dijual Cepat RumahRuko Mewah Cantik Di lokasi strategis kota Medan,Medan,Medan Helvetia,125,149,1699990000,274,Medium
Di Jual Cepat Rumah Mewah Didalam Komplek estetika Setiabudi medan,Medan,,56,94,560000000,150,Small
Dijual Cepat Rumah Mewah Cantik Dengan harga promo,Medan,Medan Selayang,80,75,795000000,155,Small
DIJUAL RUMAH CANTIK RUMAH YANG DIDESAN PERCIS RUMAH BARBIE INI MURAH MURAH LOH,Medan,Medan Johor,50,78,370000000,128,Small
MILIKI RUMAH DENGAN WARNA YANG BEBAS ANDA PILIH SESUKA HATI YANG MASTINYA MURAH,Medan,Medan Johor,50,78,400000000,128,Small
PONDOK INDAH KEMIRI DENGAN KUALITAS YANGTERJAMIN MURAH PALING TOP DEH,Medan,Medan Kota,50,96,595000000,146,Small
Dijual Cepat Rumah Mewah Cantik minimalis kota Medan setia budi,Medan,Medan Selayang,56,9375,530000000,9431,Small
Dijual Cepat Rumah Mewah Cantik minimalis ekonomis Di setia Budi Medan,Medan,Medan Selayang,56,937,427056000,993,Small
HUNIAN MILENIAL KEREN DAN ELEGANT ALENA JOHOR PASTINYA MURAH CUMA 5XXSAN JUTA,Medan,Medan Johor,70,65,540000000,135,Small
BAGUS LOKASINYA VILLA SAVERIA HANYA 6XXJUTA AJA UDAH DAPAT FASILITAS MEWAH,Medan,Medan Kota,100,108,650000000,208,Medium
Daerah Mandala Rumah 1 Tingkat Jl Tangguk Bongkar II,Medan,Medan Denai,80,120,795000000,200,Small
Daerah Pancing  Tempuling Jl RelaKeruntung,Medan,Sidorejo,92,58,680000000,150,Medium
Daerah Mandala Jl Pukat Banting II,Medan,Bantan,128,54,1100000000,182,Medium
Daerah Sutomo Ujung JL PELITA IV  SUTOMO UJUNG,Medan,Medan Perjuangan,98,38,577000000,136,Medium
Daerah Gatsu km 75 Komplek Grand Emporium,Medan,Medan Sunggal,112,84,1100000000,196,Medium
Daerah Pancing Jl Tuamang lokasi hanya 100mter dari Jl Pancing,Medan,Sidorejo,95,50,647000000,145,Medium
Rumah Siap Huni 3 Kamar Tidur di perumahan alfa78,Medan,Medan Deli,90,144,990000000,234,Small
Dijual Cepat Rumah Mewah Cantik Di lokasi strategis setia budi kota Medan,Medan,Medan Tuntungan,130,128,800000000,258,Medium
KAMI PERSEMBAHKAN RUMAH CRISTAL JOHOR UNTUK ANDA DENGAN HARGA MURAH,Medan,Medan Johor,50,84,425000000,134,Small
Dijual Cepat Rumah Mewah Cantik Di Dalam komplek setia Budi Medan,Medan,Medan Selayang,80,75,795000000,155,Small
BURUAN MILIKI HUNIAN MURAH MERIAH PERUMAHAN CANTIKA JOHOR DENGAN MEWAH,Medan,Medan Johor,50,78,410000000,128,Small
CANTIKA JOHOR PERUMAHAN BERGENSI DAN PASTINYA BERKUALITAS CUMA 3XXXJUTA AJA,Medan,Medan Johor,50,78,380000000,128,Small
RASAKAN UNIKNYA RUMAH ALAH EROPA CUMA ADA DI NAFISYAH REGENCEY CUMA 5XXXJUTA,Medan,Sunggal,50,90,525000000,140,Small
RUMAH KEREN BAGUS 5XXJT TYPE 70 ANDA UDAH DAPAT RUMAH SEBAGUS INI,Medan,Medan Johor,70,78,590000000,148,Small
RUMAH DENGAN KONSEP ANDRA MATIN DENGAN TAMPILAN YANG SANGAT ELEGANT PASTINYA,Medan,Medan Johor,70,110,711000000,180,Small
DENGAN 7XXJT AJA UDAH DAPAT RUMAH SEMEWAH INI LOH GUYS DENGAN FASILITAS LENGKAP,Medan,Medan Johor,70,132,790000000,202,Small
PERUMAHAN VILLA SAVERIA RUMAH STRAREGIS DAN MURAH HANYA 3XXJUTA AJA GUYS,Medan,Medan Kota,54,84,380000000,138,Small
RUMAH TERLARIS KOMPLEKS VILLA SAVERIA HANYA 4XXSAN JUTA AJA,Medan,Medan Kota,64,64,450000000,128,Small
RUMAH MILENIAL ANAK MEDAN VILLA SAVERIA MEDAN SELAYANG,Medan,Medan Kota,84,84,550000000,168,Small
RUMAH YANG DI DESAIN KHUSUS UNTUK ANDA DENGAN RUANGAN FLEKSIBEL DAN MURAH,Medan,Helvetia,68,108,790000000,176,Small
Daerah Krakatau Pancing Jl Karya Bakti,Medan,Medan Timur,78,36,520000000,114,Small
Daerah Pancing Jl Karya Bakti,Medan,Medan Tembung,84,40,525000000,124,Small
Daerah Tempuling  Krakatau Pancing Jl Suluh  Tempuling,Medan,Medan Tembung,110,60,720000000,170,Medium
Daerah Sekip  Gatsu Jl Sendok Komplek Grand Ayahanda Residence,Medan,Medan Petisah,78,36,600000000,114,Small
Daerah Mandala Jl Garuda  Tangguk Bongkar,Medan,Medan Denai,156,72,900000000,228,Large
Dijual cepat rumah toko di lokasi strategis,Medan,Medan Helvetia,125,1495,1700000000,1620,Medium
Di Jual Cepat RumahRuko Mewah Di Lokasi Strategis,Medan,Medan Helvetia,125,149,1699865000,274,Medium
Dijual Cepat Rumah Mewah Cantik Di Dalam komplek setia Budi Medan,Medan,,46,75,427000000,121,Small
HUNIAN MURAH CUMA 4XXXSANJUTA AJA UDAH DAPAT RUMAH DENGAN DESAIN EROPA INI LOHH,Medan,Sunggal,50,90,490000000,140,Small
AYOO GUYSS JANGAN MAU KEHABISAN HUNIAN MEWAH INI CUMA ADA DISINI CUMA 6XXXJT AJ,Medan,Medan Kota,50,102,625000000,152,Small
Dijual Cepat Rumah Cantik minimalis modern Di Lokasi Strategis,Medan,Medan Helvetia,45,96,350000000,141,Small
Dijual rumah 2 lantai di inti kota medan,Medan,Medan Helvetia,120,55,850000000,175,Medium
Daerah Amir Hamzah Jl Persatuan  Aksana residence,Medan,Medan Helvetia,120,62,620000000,182,Medium
Dijual Cepat Rumah Cantik Mewah Didalam Komplek estetika Setiabudi medan,Medan,Medan Selayang,75,105,800000000,180,Small
PERUMAHAN YANG AMAT SANGAT MEWAH CUMA ADA DI MALDINA KARYA 4XXXJUTA,Medan,Medan Kota,50,93,490000000,143,Small
Dijual Cepat Rumah Mewah Cantik Di lokasi strategis,Medan,Medan Helvetia,45,96,349856123,141,Small
Dijual Cepat Rumah Mewah Didalam Komplek estetika Setiabudi medan,Medan,Medan Selayang,56,93,427000000,149,Small
Rumah Mewah Givency One Type Dior Fasilitas Lengkap  Dekat Pintu Tol Helvetia,Medan,Helvetia,284,180,2632000000,464,Large
Sidorukun Geoju Jl Sidorukun krakataumedan,Medan,Medan Timur,80,48,725000000,128,Small
Rumah Mewah Medan Kota Full Furnish di Perumahan Givency One,Medan,Helvetia,403,219,6766800000,622,Large
Rumah Medan Tanpa DP DP 0 Persen FREE PPN Halton Place Medan Kota,Medan,,177,135,1836000000,312,Large
Di Jual Rumah 2 pintu KompClassic Tanjung Sari Medan,Medan,Medan Selayang,290,198,1521000000,488,Large
Rumah Mewah dan Murah di Inti Medan Kota Acadia,Medan,Denai,150,165,1440000000,315,Medium
dijual rumah mewah gaperta medan,Medan,Helvetia,220,200,1900000000,420,Large
Rumah Mewah Full Furnish di Inti Kota Medan Perumahan Givency One,Medan,Helvetia,284,180,4985600000,464,Large
dijual rumah 2 lantai SM Raja Medan,Medan,Amplas,84,87,760000000,171,Small
Cluster residence sukamaju,Medan,Sunggal,160,160,350000000,320,Large
dijual rumah 2 lantai ringroad medan,Medan,Padang Bulan Selayang I,200,135,1800000000,335,Large
Rumah Medan Kota Akses Strategis dekat Pintu Tol,Medan,,105,96,890800000,201,Medium
Tanpa Bunga Tanpa Bank Tanpa BI Checking selama 70 bulan,Medan,Medan Tuntungan,50,98,275000000,148,Small
Promo Free ACCanopy,Medan,Medan Selayang,90,94,905000000,184,Small
CLUSTER FADHILA SETIABUDI RUMAH CANTIK  MEWAH PASTINYA MURAH BERKUALITAS,Medan,Medan Selayang,50,72,450000000,122,Small
RUMAH CANTIK MINIMALIS DENGAN HARGA 5XXXJUTA AJA UDAH BISA DAPAT RUMAH INI,Medan,Medan Johor,80,120,580000000,200,Small
RUMAH CLUSTER KARYA DARMA DENGAN ACCSESS RUMAH YANG SANGAT TERJANGKAU PASTINYA,Medan,Medan Johor,55,80,340000000,135,Small
PALIIING LARIS RUMAH DI VILLA PONDOK SURYA HANYA 4XXSAN JUTA AJA LOH GUYS,Medan,Helvetia,40,60,425000000,100,Small
Daerah Madong Lubis  Sumatera Jl Kucing,Medan,Pandau Hilir,188,78,1800000000,266,Large
Daerah Sutomo Ujung JL Perbatasan,Medan,,100,32,700000000,132,Medium
Daerah Aksara JL SELAM IV  AKSES ASIA MEGA MAS,Medan,,340,229,1900000000,569,Large
SAVANA LAU HOUSE FOR SALE WITH STRATEGIC RESIDENCE,Medan,Medan Johor,50,84,375000000,134,Small
di jual perumahan  yg desain khusus dan cuantik,Medan,Medan Kota,50,108,615000000,158,Small
DI JUAL RUMAH DENGAN HARGA PROMO CASH KERAS HANYA 775 JUTA RUPIAH,Medan,Medan Johor,125,105,775000000,230,Medium
di jual rumah kawasan yg super duper mewah  dan strategis,Medan,Medan Sunggal,50,105,565000000,155,Small
PERUMAHAN DI SETIA BUDI,Medan,Medan Tuntungan,50,101,525003000,151,Small
di jual rumah dan semua Kebutuhan hidup Hanya selangkah dari Rumah anda,Medan,Medan Kota,50,108,615005000,158,Small
di jual rumah yg memilki hunian nyaman strategis dan super mewah,Medan,Medan Helvetia,60,95,635000000,155,Small
Dijual Rumah dengan harga Disc Khusus Cash Keras,Medan,Medan Johor,125,105,775000000,230,Medium
Rumah Dengan Harga yang Sangat Masuk Akal di Kawasan Super Mewah,Medan,Medan Helvetia,60,95,635000000,155,Small
RUMAH DI LOKASI SUPER MEWAH,Medan,Medan Helvetia,60,95,635000000,155,Small
RUMAH STRATEGIS BERNUANSA BALI MODERN,Medan,Medan Sunggal,50,105,625000000,155,Small
Dijual Rumah dengan sangat ramah di kantong,Medan,Medan Selayang,50,105,565000000,155,Small
Perumahan 2 lantai dengan harga disc,Medan,Medan Johor,125,105,775000000,230,Medium
Perumahan Paling Strategis Membuat Hidup Serba Ekonomis,Medan,Medan Kota,50,90,615003000,140,Small
Dijual Rumah di Lokasi Paling Mantap,Medan,Medan Selayang,50,105,565003000,155,Small
Perumahan Paling Strategis Membuat Hidup Serba Ekonomis,Medan,Medan Kota,70,90,805003022,160,Small
Rumah Idaman Keluarga Baru,Medan,,80,90,718000000,170,Small
Perumahan Paling Strategis Membuat Hidup Serba Ekonomis,Medan,Medan Kota,70,90,805003022,160,Small
JUAL RUMAH BERNUANSA BALI MODERN,Medan,Medan Baru,50,105,565000000,155,Small
Dijual Perumahan di Lokasi yang strategis,Medan,Medan Johor,125,105,775000000,230,Medium
One gate system,Medan,,54,84,385000000,138,Small
Rumah Hook Keren Banget,Medan,Medan Selayang,75,112,700000000,187,Small
Minimalis Dekat Kampus  Ringroad,Medan,Medan Selayang,50,72,450000000,122,Small
Rumah daerah Krakatau 50mtr dari BCA krakatau Jl Sibual Buali,Medan,Glugur Darat I,136,92,950000000,228,Medium
Daerah Inti Kota Jl Bakaran Batu simp Gandhi,Medan,,240,138,1850000000,378,Large
Terletak di Jl Tuasan daerah Sutomo Ujung Krakatau,Medan,,98,44,805000000,142,Medium
Rumah Super Strategis di inti Kota Bernuansa Bali Modern,Medan,Medan Selayang,50,105,565000000,155,Small
SWEET AND ATTRACTIVE HOUSING FOR SALE,Medan,Medan Johor,60,95,635000000,155,Small
a super duper strategic house for sale with a modern Balinese feel,Medan,Medan Johor,50,105,565000000,155,Small
SEGERA BOOKING PERUMAHAN ALFA78 banyak Disc  Gratis lainnya,Medan,Medan Deli,90,144,742000000,234,Small
DI JUAL RUMAH TERBEST DI GRIYA PONDOK SURYA,Medan,Medan Helvetia,60,95,635000000,155,Small
special design house for sale,Medan,Medan Kota,50,108,615005000,158,Small
PERUMAHAN STRATEGIS LINTAS SUMATERA DI SM RAJA TENGAH KOTA,Medan,Medan Kota,50,90,615003000,140,Small
Rumah Dengan Harga yang Sangat Pas di kantong di Kawasan Super Mewah super str,Medan,Medan Selayang,50,105,565003000,155,Small
Lokasi Perumahan Super Strategis akses serba Praktis,Medan,Medan Tuntungan,50,101,525000000,151,Small
di jual perumahan model minimalis dan modern,Medan,Medan Kota,125,105,825005000,230,Medium
Di Jual Perumahan Paling Strategis Membuat Hidup Serba Ekonomis,Medan,Medan Kota,50,108,615000000,158,Small
RUMAH DI SETIA BUDI SUASANA BERASTAGI,Medan,Medan Selayang,50,101,525000000,151,Small
Dijual Rumah 1 lantai di lokasi Strategis,Medan,Medan Helvetia,60,95,635000000,155,Small
PERUMAHAN STRATEGIS LINTAS SUMATERA,Medan,Medan Kota,70,90,805004000,160,Small
Rumah dengan harga yg sangat pas di kantong,Medan,Medan Tembung,50,84,375003000,134,Small
Rumah Dengan Harga yang Sangat Pas di kantong di Kawasan Super Mewah super str,Medan,Padang Bulan Selayang II,50,105,565003000,155,Small
Rumah 1 lantai di lokasi super mewahh,Medan,Medan Tuntungan,50,101,525003000,151,Small
SAVANA LAU DENDANG HUNAN DI LOKASI TERBAIK,Medan,Medan Tembung,50,84,375004000,134,Small
PERUMAHAN ROYAL SEMBADA PERUMAHAN MEWAH BANYAK DIBELI BANYAK ORANG 8XXXJT AJA,Medan,Simpang Selayang,105,105,800000000,210,Medium
PERUMAHAN GRIYA NUSA BALI DENGAN DESAIN YANG MENARIK DAN INTERIOR BAIK 4XXXJT LO,Medan,Medan Kota,50,84,475000000,134,Small
PERUMAHAN MODERN CLUSTER FADHILA SETIABUDIRINGROAD DENGAN KUALITAS TERBAIK,Medan,Medan Selayang,45,60,400000000,105,Small
PERUMAHAN GRIYA NUSA BALI DENGAN DESAIN YANG MENARIK DAN INTERIOR BAIK 4XXXJT LO,Medan,Medan Kota,50,84,475000000,134,Small
PERUMAHAN MODERN CLUSTER FADHILA SETIABUDIRINGROAD DENGAN KUALITAS TERBAIK,Medan,Medan Selayang,45,60,400000000,105,Small
Perumahan Wonosari Asri Residence Dengan Kualitas Rumah Mewah Dan Harga Murah,Medan,Medan Kota,39,87,168000000,126,Small
DIJUAL RUMAH MEWAH DENGAN HARGA MURAH DENGAN FASILITAS BINTANG LIMA,Medan,Sunggal,60,127,369000000,187,Small
RUMAH READY DI TEMBUNG CUMA 3XXSAN JUTA AJA UNTUK BISA ANDA BELI SEKARANG,Medan,Medan Tembung,60,143,370000000,203,Small
Tanpa Bank Tanpa Bunga Tanpa BI Checking selama 70 bulan,Medan,Medan Tuntungan,50,98,275000000,148,Small
Terlaris Terjangkau Terfavorit,Medan,,84,84,570000000,168,Small
Perumahan Double Dinding,Medan,Medan Selayang,50,105,535000000,155,Small
Dekat Kampus Unika USU Methodist,Medan,,65,120,510000000,185,Small
Promo Gratis Biaya,Medan,Medan Johor,45,84,480000000,129,Small
MEMPERSEMBAHKAN PROJEK TERNAMA CLUSTER COLUMBIA DENGAN HARGA YANG SANGAT MURAH,Medan,Sunggal,50,87,295000000,137,Small
PERUMAHAN MINIMALIS MODERN,Medan,Medan Johor,125,105,775004000,230,Medium
Gratis Biaya AJB BBN BPHTB,Medan,Medan Amplas,84,84,780000000,168,Small
Rumah Dekat Padang Bulan Medan,Medan,Medan Selayang,75,84,550000000,159,Small
Daerah Sutomo Ujung JL Setia Jadi,Medan,Medan Perjuangan,112,60,740000000,172,Medium
Ruko di jl Hm Yamin JALAN Large LANGSUNG,Medan,,292,112,2300000000,404,Large
Daerah Mandala Jl Selam IV,Medan,,130,110,1400000000,240,Medium
PERUMAHAN DI SETIA BUDI SUASANA BERASTAGI,Medan,Medan Tuntungan,50,101,525003000,151,Small
Rumah Kompleks Griya  Pondok SuryaTidak Banjir Dekat Tol Helvetia,Medan,Medan Helvetia,60,95,635000000,155,Small
di jual perumahan bernuanasa berastagi,Medan,Medan Selayang,50,93,525000000,143,Small
PERUMAHAN DI SETIA BUDI SUASANA BERASTAGI,Medan,Medan Tuntungan,50,101,525000000,151,Small
di jual rumah yg sudah terdekat dengan jalan tol tembung,Medan,Medan Tembung,50,84,375005021,134,Small
di jual rumah serba praktis dan adem di berastagi,Medan,Medan Tuntungan,50,93,525000000,143,Small
MILIKI HUNIAN YANG NYAMAN DI LOKASI SUPER MEWAH,Medan,Medan Helvetia,60,95,635000000,155,Small
Rumah Lokasi Paling Strategis Di Medan Marelan,Medan,Medan Marelan,120,130,650003000,250,Medium
Miliki Hunian yang Kemanamana Praktis,Medan,Medan Tembung,50,84,375003000,134,Small
sweet and minimalist house for sale,Medan,Medan Johor,125,105,775005000,230,Medium
Perumahan Paling Strategis Membuat Hidup Serba Ekonomis,Medan,Medan Kota,50,108,615000000,158,Small